sachin_rt	M
katyperry	F
justinbieber	M
BarackObama	M
taylorswift13	F
ladygaga	F
jtimberlake	M
rihanna	F
britneyspears	F
Cristiano	M
JLo	F
KimKardashian	F
shakira	F
selenagomez	F
Oprah	F
Harry_Styles	M
jimmyfallon	M
KAKA	M
Drake	M
aliciakeys	F
BillGates	M
BrunoMars	M
KingJames	M
pitbull	M
MileyCyrus	F
Eminem	M
Louis_Tomlinson	M
NICKIMINAJ	F
AvrilLavigne	F
KevinHart4real	M
neymarjr	M
EmWatson	F
davidguetta	M
aplusk	M
danieltosh	M
ConanOBrien	M
MariahCarey	F
ActuallyNPH	M
xtina	F
SrBachchan	M
JimCarrey	M
chrisbrown	M
kourtneykardash	F
Beyonce	F
khloekardashian	F
RyanSeacrest	M
edsheeran	M
ParisHilton	M
iamwill	M
ashleytisdale	F
LeoDiCaprio	M
iamsrk	M
tyrabanks	F
AlejandroSanz	M
aamir_khan	M
SnoopDogg	M
ricky_martin	M
kanyewest	M
10Ronaldinho	M
SimonCowell	M
narendramodi	M
BeingSalmanKhan	M
WayneRooney	M
ClaudiaLeitte	F
carlyraejepsen	F
DalaiLama	M
andresiniesta8	M
ZacEfron	M
3gerardpique	M
LucianoHuck	M
marcosmion	M
KendallJenner	M
kelly_clarkson	F
deepikapadukone	F
radityadika	M
paurubio	F
paulocoelho	M
KDTrey5	M
tomhanks	M
imVkohli	M
priyankachopra	F
rustyrockets	M
nickjonas	M
MesutOzil1088	M
stephenfry	M
iHrithik	M
XabiAlonso	M
VictoriaJustice	F
lindsaylohan	F
KylieJenner	F
enrique305	M
TheRock	M
aguerosergiokun	M
victoriabeckham	F
AustinMahone	M
jessicaalba	F
akshaykumar	M
annecurtissmith	F
RafaelNadal	M
Carles5puyol	M
cesc4official	M
StephenAtHome	M
SofiaVergara	F
joejonas	M
rickygervais	M
ChespiritoRGB	M
Guaje7Villa	M
Persie_Official	M
channingtatum	M
JohnCena	M
msdhoni	M
snooki	F
CherLloyd	M
rafinhabastos	M
SBYudhoyono	M
JessieJ	F
BigSean	M
GarethBale11	M
JColeNC	M
carmeloanthony	M
ImRaina	M
kobebryant	M
KELLYROWLAND	F
Pharrell	M
juniorbachchan	M
cbabdullahgul	M
ollyofficial	M
ciara	F
sonamakapoor	F
SarahKSilverman	F
DaniAlvesD2	M
jennettemccurdy	F
rioferdy5	M
shireensungkar	F
Fearnecotton	F
karanjohar	M
bellathorne	F
143redangel	F
elissakh	F
JuanLuisGuerra	M
PerezHilton	M
Pontifex	M
DwightHoward	M
SteveMartinToGo	M
DulceMaria	F
andersoncooper	M
RaffiAhmadLagi	M
pewdiepie	M
Ricardo_Arjona	M
shahidkapoor	M
iansomerhalder	M
realpreityzinta	F
KeshaRose	F
eddieizzard	M
Riteishd	M
jorgeemateus	M
robdyrdek	M
paulwesley	M
SeanKingston	M
hitRECordJoe	M
TheShilpaShetty	M
felipeneto	M
gulbenergen	F
juliaperrez	F
alexoficial	M
ochocinco	M
bipsluvurself	F
jaimecamil	M
shreyaghoshal	F
Adela_Micha	F
LuisChataing	M
officialtulisa	F
AshBenzo	F
ChrisMoyles	M
FinallyMario	M
BillSimmons	M
EleanorJCalder	F
belindapop	F
JakeTAustin	M
LAURAGII	F
DollyParton	F
JoshDevineDrums	M
MadhuriDixit	F
samuelmilby	M
neiltyson	M
luisnani	M
UncleRUSH	M
FreddyAmazin	M
Fergie	F
Schofe	M
PrincesSyahrini	F
paulpierce34	M
DannyDeVito	M
TravieMcCoy	M
_Pedro17_	M
LaurenConrad	M
jasonderulo	M
FelipeCalderon	M
dilmabr	F
GiulianaRancic	F
NellyFurtado	F
Angelluisr	M
HillaryClinton	F
JoelOsteen	M
TherealTaraji	F
ana_maria_braga	F
sneijder101010	M
JoyceMeyer	M
ValeYellow46	M
jackwhitehall	M
questlove	M
pattiemallette	F
BradPaisley	M
manomenezes	M
MrPeterAndre	M
jessicacediel	F
1LVA	M
billclinton	M
nikkigil	F
aristeguicnn	F
Schwarzenegger	M
VINNYGUADAGNINO	M
petewentz	M
GemmaAnneStyles	F
chrisrock	M
ajaydevgn	M
SaraBareilles	F
PaulaFernandes7	F
DrakeBell	M
JamesFrancoTV	M
RobertsEmma	F
maddow	F
1LoganHenderson	M
lemontwittor	M
DaniellePeazer	F
YUVSTRONG12	M
dylanobrien	M
rickyrozay	M
themichaelowen	M
jamesmaslow	M
RomeoSantosPage	M
danawhite	F
JohnBishop100	M
damnitstrue	F
JanetJackson	F
DaneCook	M
DavidHenrie	M
AndreaSernaRCN	F
RealTracyMorgan	F
smoss	M
MarthaStewart	F
NathanFillion	M
blakegriffin32	M
HaifaWehbe	F
ReggieBush	M
andy_murray	M
billmaher	M
ShawnMendes	M
williecolon	M
michkeegan	F
Joey7Barton	M
heidiklum	F
DaRealAmberRose	F
ShashiTharoor	M
ConnorFranta	M
TimTebow	M
jhutch1992	M
geneliad	F
AnselElgort	M
Su_Gimenez	F
mcuban	M
realDonaldTrump	M
steveaustinBSR	M
shitmydadsays	M
ashleesimpson	F
rogerfederer	M
LeighFrancis	M
wilw	M
sethmeyers	M
Alyssa_Milano	F
andreolifelipe	M
ashleeadams	F
KateEllisMP	F
BellaIsaMaria2	F
jaamiecurry	F
LiamMcEwan F
lauramarano	F