but barred could chat effects feel holding had has lapsed micheal no of still time the whispering with	M
and everyone happy joy vishu! wishing	M
and at meeting them with wonderful	M
hello shangai!!	M
and achievement being congratulations crowned doubles inspire in more no.1 on pursue terrific to the will world	M
and by fabulous fightback great hitting led nearly off pulling showed spirit the	M
am apun cheering dugout first guess game home in ka of our superstars the whatever	M
guess whaaattt	M
and but condolences cricket enthusiasm full family friends great heartfelt loss not of richie's to the well world was	M
art along discussion fondly him in leg late last on of official our remember spoke sharjah spin to the with year	M
#riprichie and always encouraging great game had insights on personality the warm who wonderful was	M
and all both best congratulations for great it indian making on open'! srikanth to the wishing you	M
2011 as fondly for golden into mcg memories of remembered the walked	M
after amp; as being best daniel from great moments odis of part retire some they the very vettori wish	M
5th australia congratulations cup! consistent during day for new on performance tough their to the world with zealand,impressed	M
and aspiring country done for in keep model on! persons role smashing sports them true the well	M
be becoming congratulations first indian number on to the woman world	M
#cwc15 and by convincing difference finish for finch's hundred, him johnson made smith's support steve strong to the win	M
and australia all but cricket congratulations enjoyed fans have played some terrific to throughout the watching you	M
and always cup difficult game handle icc india is in loss played tough to the team today well world	M
but love symmetry	F
\ud83c\udde8\ud83c\uddf3\ud83c\udf52fruit is sister	F
\u2764\ufe0fall and for packed ready	F
9\/29! 9\/25 \ud83d\udc90brazil!\ud83d\udc90 amp; as added curitiba for go i've in on out paulo rio, rock selling sao special thank you	F
17th 10a: 3rd! \ud83d\udc83\ud83c\udffbbuenos aires! april at back coming for i\u2019m on october pre-sale tickets you	F
see silk to wearin	F
krafts on	F
coming for your	F
coachella community doing leftshark spotted service	F
\ud83d\udd25 fka in ktz	F
are crowns flower floppy hats new the	F
app find my need only this the weekend: you	F
#crotchella all cut compiled crotches it if jeans like off of smell this the what would worn weekend you	F
feel lte my on seeing safe so	F
\u2764\ufe0f\u231a\ufe0foh blow fine, fine hey mickey my mind, so you're you	F
strongest	M
#fishin	M
#whereareunow \"jack and are bieber choreography for looking me on put search up vids whereareunow with youtube	M
better family nothing than	M
job ladies nice	M
guy is jackson jacket michael that wearing	M
like really you	M
\u2014president \"climate be can change denied\u2014or ignored.\ longer no obama	M
about address, commitment his in obama president to talks the watch: weekly	M
#obamatownhall and child care, check equal full from icymi: on out pay, the video	M
(h\/t article big climate change: debunks myths on six this	M
\u2014president \"we and between choose family.\ have raising rewarding shouldn't to work	M
\u2014president \"things and are child care, days, equal economic family issues.\ issues like leave, paid pay\u2014these sick these	M
\u2014president \"anything back country.\ entire holds obama that the women	M
\u2014president \"ensuring equal for is no-brainer.\ obama pay women	M
\u2014president \"because changed, change have our obama them.\ to we workplaces with	M
\u2014president \"i broad-based believe call economics.\ economic growth it in middle-class that's we why	M
\u2014president \"we all everybody's fair got have in make play part sure shot society.\ that this to	M
at champions change event for fighting highlighting is live: of obama people president speaking working	M
2:10 are at americans celebrate et for fighting in obama president p.m to tune who working watch	M
happy	M
annual eighth house hosting is live: ride soldier the warrior wounded with white	M
and about equal is leave, live: more obama paid pay, president speaking with	M
and are: as child care everyone equal economic for it's pay priorities see to they time the	M
#1 1989 album at excited handwritten my on see so tour-mate to world	F
just so	F
14 billboard got going guys have nominations on outdone really situation this we've with whole yourselves you	F
\"lorde \"facetiming and are amp; at constantly do from fighting fighting\"-by loling media, mean nz say taylor thnx to us when you\ you	F
about able abigail be caring enough for i'll much never showing so surprise thank to up you your	F
surprise the	F
part surprise the	F
part surprise the	F
that well	F
calvin for getting hope! klein ponies ready summer stables thank this the were you	F
by eugenia gulsen\nhat jacket kim\nshoes olcay	F
amp; are competing donate emotion for i'm losing, money me, manager mom, my raise revolution! to	F
!! can't on paulson sarah to work with wait	F
and all be bless family, god mama praying we'll you your	F
and about are awareness challenges help health important me mental so spread survey take they the why youths	F
about and as america emotion health here, learn mental on our revolution raise to take we youth	F
artists both blessing changed generation inspiring lives music next of our song see such to that the we wrote	F
me	F
\ud83d\udc97 and already grandma had in love much my pacemaker put so she she's up walking yesterday,	F
\ud83d\udc83gotcha april fools!	F
i'm music pop quitting	F
#basicmyass	M
happening?! is thank what you, you	M
and congrats thank to wow you	M
and are bday call earth gift genius glad happy know p-- so this to too!!! you	M
are drink everybody!! enjoying easter have hope happy no! ok really should that the what's weekend! yes you	M
#tbt after awards bell choice over people's squad that taco took to time the whole	M
#iheartawards forever from i'll last moved night remember so still this	M
award boss congrats innovator my on other tonight!!!\u2026 to the winning	M
and all am awards: by dearly everyone for humbled in love much of piece participated so thank that to who you	M
8\/7c awards! at during honor live music nbc on tonight the we	M
#americanoxygen date...watch here have important made most music of one to the videos worldwide	F
#americanoxygen get new right the worldwide	F
#rockinrio2015 #rockinrio 000 57 85 can't in is kind minutes of rih sold slayage tickets thank this\u201d what wait! you	F
#ao ---&gt; here it now!! out video watch	F
#bbhmm	F
#americanoxygen --&gt; as demanded----&gt; now on you	F
asap.\u201d american be comin!!! needs oxygen release she to	F
and every fucking goosebumps!!! give legit me sang shit that word!!!! you	F
away!!! blew fun forget had how indiana!!!! love me much man!! never one tonight!! thank would with you	F
\ud83d\udc40 backstage rihanna right	F
be fucked had huh only part so\u2026 stream to there!!! typical\u201d the up was you	F
break spring	F
in now on tune	F
more	F
bryan birthday! day! good guy have hope happy love this to wish want you	F
#fly beautiful chills doing for gives me so this video what watch you're	F
coming for fun had hope last meet night\u2026 nice so to thanks you!	F
#pieceofme at action back in see vegas! you,	F
on our set to way	F
boys!! dance ever favorite just my of one shot scenes these with	F
are best cool for guys is omg!! so thank this the you	F
\ud83d\udc40 \ud83c\udd99, \u2b07\ufe0f, girls jaws on roll the us, windows	F
aren't girls pretty these	F
\ud83d\ude0a at beautiful boys day easter for hot little look my these with	F
\u2764\ufe0f and about always be cory family guy his hearts in our sweet, thinking this today will wonderful	F
is my son true	F
#dips are new the thing	F
am amp; can't everyone future holds! means of proud show see support so thank to this the voted! what who world wait your you	F
amazing beyond best for grateful have heard just loyal news!! pom show some such to voted was	F
\ud83d\ude2d and already back boys best home missing to the vacay week work! with	F
flies!! thank time you!	F
love this thank you!	F
15th ;) \"oops\ aww birthday everyone have happy shouldn't to wishing you	F
#vivaronaldo about entered for have just madrid my on predictions what	M
birthday celebrating great of the	M
#cr7underwear and about available, comfortable, fabric good is it light making microfiber my now news very	M
and all body can! exercise for good it's you your	M
all excelent for goals have happy scored support thank this to team work with you your	M
dinner good nice with	M
and amazing experience in love materials, of quality service suits, stores try tailor-made the	M
and enjoying family is i'm precious time	M
#euro2016 against closer for important one serbia step to team the win	M
could for hey little match! more next our speed thought use you	M
as braz\u00e3o camisola cores da nome nossas nova na nosso orgulho p\u00f5e teu	M
badge colours name national new on our put pride team the your	M
ahead clasico el game make now of on prediction sportlobster the weekend your	M
edition! have i'm my proud special to	M
#vivaronaldo about barcelona entered for have just madrid my on predictions what	M
#mercurial cr7 football get it in my nike new now on saw snapchat! the you	M
jeremy lin to team the welcome	M
ago forget forgotten friends fled his home has he names old of the we won\u2019t years zaid	M
and are commitment, drive dedication, hard of some succeed share that to the values work	M
all champions\nleague day is real set! tomorrow vamos	M
\ud83d\ude30\ud83d\ude30\ud83d\ude30\ud83d\ude30\ud83d\ude30\ud83d\ude30 day long	F
#bethegirl #fbf and buy free: get one second the tastyshake with	F
\ud83d\ude18 fun lolol! this was	F
#kuwtk all an happy make new sure sunday! to watch	F
amp; kourtney our with	F
and amp; few gonna going her honor in kourtney of pics post thru	F
big birthday happy love my sister sooooo to you	F
4am but cover call come day excited for long so shots shoots today! these to time today	F
bad!!!! hair laser need removal	F
just oh	F
#time100 2015 be full in included list proud see to the	F
crazy copy everyone gilt! got it in on of out selfish sold to thanks who	F
it's	F
500 at copies, exclusive et from get going i'm noon only post some signed selfies tomorrow the to yours	F
exclusive, limited-edition my new obsessed of release, version with	F
for getting in launch my paris party touch the ups	F
am crazy!!!! dress excited for fitting last met night sooooo this was	F
came everyone guys! in loved launch of out paris support seeing thank to today! the who you	F
birthday doll! happy love	F
24 amp; cute for hours is lots like me on of selfies! spread thank this taking what with	F
#kbeautyhair at champs eleyse european for getting launch our paris ready the today	F
bye	F
15 alas-bid days educators extraordinary just know left most nominate premios participate to the you	F
15 aquellos alas-bid conoces d\u00edas educadores extraordinarios los nominar para participa premios quedan que solo	F
\/ de for out paseo! stroll! sasha	F
#latino across behalf discussing educational is in nation nyc on of opportunities strategies the today	F
#latinos de discutiendo estrategias est\u00e1 en eeuu educaci\u00f3n hoy la mejoramiento nueva para york	F
\"el baby gran ha informaci\u00f3n: impacto, m\u00e1s mundial shower seg\u00fan tenido un	F
\ud83d\udc4d \"world big baby full hit, is says shower story:	F
202 a\u00f1os barranquilla celebramos de estos mi	F
#tbt 2013 by de del el en fragancia la lanzamiento par\u00eds! primavera shak shakira	F
#tbt 2013 at by here's in launch paris spring shak shakira the	F
--a alegria canci\u00f3n como gusta la les nosotros! nos ocurre para qu\u00e9 que se tanto ver	F
#quintanaroo 632 ayer beneficiados cipis! con de desde dos en inauguraci\u00f3n la m\u00e1s nuevos ser\u00e1n	F
\"working and collection ecd--he fp from for kick loves my out\ play piano sasha w\/his	F
\"haciendo colecci\u00f3n con de ejercicio\ gimnasio le mi su sasha	F
community comunidad de excited hace ilusi\u00f3n i'm join la me mucha the to unirme	F
according about benefits childhood early economist holistically of should to the think we	F
#tbt 1r \u00e1lbum aniversario celebramos de del el en es fotos la las nuestro oficiales! que semana shakira, una	F
#tbt 1st album birthday, celebrates is in its official of our one press shots! shakira the week	F
amp; beach collection full follow is my neo of out summer to the vibes! win	F
\ud83d\udcf7\ud83d\udcf7\ud83d\udcf7\ud83d\udcf7 backyard	F
and away from god grass in is jump ran run so studio to the	F
bless easter!! everyone! family fam god happy la missing my spent today with	F
#texastradition \ud83d\ude48 from home know love pickles ship them when you	F
and always atlanta guys!!!! im in i'm now!! right so shooting sorry thank there you!!!!!!	F
#myneomoves amp; beat bust chance can\u2019t fight it's it last move to tweet the using your	F
back drac's is pack	F
again be bub for my nat stay stoked to tuned working with	F
#myneomoves and be could how instagram in me next on show twirl the using you	F
everybody! goodnight	F
my	F
#dracpack #hotelt2 back! for fall, is this the trailer watch	F
carineroitfeld family my paris riccardotisci17	F
and again another for greatness of thank you're year you	F
is out!!! the video	F
are beautiful for i'm my pastors thankful they today	F
and all for loved pig rooster story that thanks wow watching	F
#a curiosity curious don't discipline how its's into mind profound real turned think y'all	F
curiosity everybody for is meet possibility you	F
agree curiosity feel in the your	F
advice great have ideas! own to you your	F
first got his how job know love of story this	F
both bit curiosity eavesdropping of or right	F
better great getting hear just keeps life signed so to up you're	F
and are ask he's interesting more people questions right who	F
\"a bigger curious for is life living leads mind\ proof sure to	F
creates curious for great how is mind people ready success story see so to yours	F
#blueheron backyard for found in koi look looking my sitting too who	F
big coy gotten loving my over so they've	F
15 celebrating day for lovely of party years	F
20 calavie chef found is my rosie where years	F
\"as as are breathing is long matter more no right there than what wrong with you	F
doing friend girls my re spa we watching with	F
birthdays happiest of to	M
all been for far five it's it isn't lovely support so thank years you your	M
all crew came dubai everyone far, for great huge had having in last show so thanks to tour the us we who	M
birthday good have happy one	M
at everyone events garissa incredibly in involved kenya.\nsuch news of sad thinking the university	M
\nsee dubai forward in looking our show soon to you	M
all cape can't for forward hey in looking seeing town tonight to wait you	M
\"dollar and feeling in pocket, you're your	M
all amazing everyone for kcas last much night so thank the voted who you're you	M
amazing coming for fast fell in johannesburg, love thank tonight were with you	M
always all as love the	M
!!\n\ni and both can't for first good love luck see to the wait you	M
be can't for feels good in it'll jakarta like one show the wait	M
amazed by hope is last manila, more night of same the tonight we were you	M
#cleanwaterforall 2015 day it's water world	M
all can't for forward looking manila, seeing shows there to the wait you	M
amazing for fun hong had having hope kong thank tonight thanks us were you	M
day everyone good has hope happy patrick's st	M
birthday day happy have nice paige	M
for great the thanks	M
bathroom can copy few hook me on of out there's the up vinyl?\u201d wall with you	M
and buy don't get have if local one record store! to turntable you your	M
#thedish -- \u201ci choose have he i'm meal on share this to wants would who with with\u201d	M
correspondent check new our out tech	M
#thankyounotefriday! and fun it's show tonight:	M
#fallontonight \"holiday\ and classroom classic hit her instruments sing with	M
#tbt and crushes can't even it little maybe on performance show song stand still tonight the up	M
comedy does on our show stand up update:	M
and as bit crazy cool do good got madonna roots tv to well with	M
all can expectations exceeds inspiring is madonna performance see tonight the why you	M
#rebelheart amp; fun is on performance show something tonight!! talk, the	M
and challenge play the whisper	M
\"exercise.\ and consider dad lawn mow mower my on riding that the would	M
#mycrazyfamily and about be could embarrassing funny, family game! hashtag member on our or out tweet thing tag weird, with	M
amp; by game louis-dreyfus plus performs playing stops tonight: the whisper w\/julia	M
and c.k for fun first here! is louis plus revealed show the to time talking tonight:	M
#repost next to the	M
#repost next to the	M
\ud83c\uddea\ud83c\uddf8 \/\/ \ud83c\uddfa\ud83c\uddf8 \ud83c\udde7\ud83c\uddf7 and all bless bendiga d\u00edos god, nos protect proteja que us	M
\ud83c\uddea\ud83c\uddf8 \/\/ \ud83c\uddfa\ud83c\uddf8 \ud83c\udde7\ud83c\uddf7 and all bless bendiga deus d\u00edos god, nos protect proteja que us	M
bom dia	M
bellissima bene! molto	M
bjo! obrigado pelo	M
bom	M
ainda em encerrar n\u00e3o! nao penso	M
liked portland	M
di forza spero si	M
depois foto manda	M
la no pierdas	M
abra\u00e7o	M
bjo brigado pelo	M
\/\/ drake future jungle tour with	M
now	M
and drake footage homecoming in james not on prince supporting stand together theatres the	M
entire for here is lineup the	M
and any drake feel film homecoming have is it inform in my not or ovo protect part responsibility something to the	M
14th at be cricket dubai ever excited for first in international march on performing to time the	M
do hear new on to tour the what want you zealand\/australia	M
ain't pnd ray tay the wit	M
are breed birthday cats done everything for go have happy me rare thank to you	M
an code day goes...we gain how hope in it of one stone suh then this understanding wrote you	M
gon we	M
for good in times, tunes, tune	F
#givenchy #paris #cityoflove \u2764\ufe0f again\u2026 deeper every for fall meet paris! thank till the visit! we with you	F
#givenchy #dahliadivin #paris \ud83d\ude18 parisian swag	F
#givenchy #dahliadivin #paris everyone happen! magic makes thank to the who you	F
#givenchy #dahliadivin #paris \u2764\ufe0f\u2764\ufe0f\u2764\ufe0f day! what	F
;-) beautiful day! for go!! it's name spring!!! thank thankful things you your	F
\u26a1\ufe0f\u26a1\ufe0fone and all burnt down greatest into look my of popped piano session the who	F
love my mens!!!	F
for song's this	F
just posted	F
just posted	F
beautiful be continuous day family! me may of opportunity reminded reborn to the today with	F
#warriorwomenweekend amp; amazing at by follow get inspired it\u2019s ig on women	F
#rise&amp;grind just leaving work!!goodmooorning!!!!!!!!!	F
#flygirls! and love regine sending to	F
#tidalforall and beyonce cheers! me my sis	F
my superwomen! turning tide the with	F
#repost beautiful...but inside mama! on repostapp.\u2070\u30fb\u30fb\u30fb\u2070yes they're too the with you	F
can change everything music of power the	F
changes game live now on the	F
200-year-old be could cure for interesting in new research tuberculosis up wrapped	M
\u201cthe for great london\u2019s modern paved stink\u201d sewerage the way	M
about are for how learned next on road to talk the unprepared what we when went	M
#madmen, as better century cool is life looks mid-20th on the way	M
an bulb can fight help innovative light	M
but die health: just measure makes not new of, to us what we way	M
better create dress ebola great helping is maker this to wedding	M
always doesn\u2019t economic growth improve on well-being	M
as computers computer do hiv infect many might possible routes to the use worms	M
be been born expectancy ghana, had in if life my would years	M
2011, an built engineering help he in lives save student so to the wanted	M
an aren't can epidemic how help just pretty pictures predict these they us will	M
ascend are cell explains from helping how phones women	M
be bad could deadly epidemic flu how here's is prevent really this we	M
#tedtalk: be but could devastating epidemic ebola is my next new tragic the	M
africa\u2019s actually an crisis example ebola is of progress the	M
as bean could developing even feed help in millions this temperatures the world,	M
\"on anyone book demonize great holds is immunity\ not opposing out that to who	M
\u201con amp; beautifully exploration immunity\u201d is misinformation mother\u2019s of surrounding truth the written	M
10 ask ceo can from her in learn lot minutes you	M
easter happy	M
#remix	M
#classicjokefriday\u201d and bruno do did for feelin how i'm mars planet party see there throw what you	M
chu preeshiate	M
new that	M
again i'm songs writing	M
sweet! thank too that was	M
love we	M
aaaaaaayyyyyyy! congrats everyone for happen making thank this to you	M
anniversary happy iconic most on show to the	M
i've so this twice week whiplash watched	M
b-day happy to the	M
just posted	M
and are in! make on performing sure squad super tonight! the tune you	M
if reading this you're	M
activated dark thirty-23 zero	M
#nike 1-100\n#lebronsmix coming package soon special	M
and all apart beautiful congrats event know ladies of to that today the who were young	M
#prompromise 3rd annual commitment for mrs_savannahrj of proud queen so to these you your	M
and cousins can game love like lil make my man seeing they tonight!! uncle when y'all	M
#riplaurenhill \nlebron \n\nsincerely, and again, all be continue care love! leader meet officially that to take until we	M
and afraid, about be cause can don't family friends grandma hello knows my of please plenty said spoke she tell we your you	M
and being by better biggest don't far fun have in impact just much made now of please place there to them the up w\/o you're you!!	M
but chance every for forgotten got have in inspired know life me meet never person to touched, time! that the whole you	M
\nyou are courage, dear definition earth etc etc! hill, lauren leadership, never on of power, strength, spent true time the will your	M
#kickgamecray #swooshlifer #itsgettingridiculousnow 12 game kicks!! lows lebron post	M
2x been cause highest i've know last mountain night so surprise top to the wasn't with	M
and at behind back bunch drilling dentist docs from going had hearing i'm me my on of so the	M
and consist evening easter my of this vino	M
and absolutely all brother congrats day for great homie journey my man nike on the	M
#swooshlifer #wheattwelves #kickgamecray #outtoday \"wheaties\ eating they today!?!?! who	M
and all congrats especially for fans!! guys last love much my night so thanks the today ya'll	M
and brother did game!! happen just last my man night sometimes to the whole work watch	M
#dale #mrworldwide #mr305inc album finishing guess is my name spanish the what	M
#idontlikeit for great job lip of sync your	M
#tbt \"mr and been cnn education\"here's i've interview named the	M
#teampitbull coming for later month, new orleans see this we're you	M
check doesn\u2019t it\u2019s in if miami matter music no out or revolution: stopping there\u2019s tech, the	M
#lovefl about county in miami-dade night saturday thinking	M
#dale #tbt can\u2019t for global my new recording release spanish warming wait	M
around all celebrate go the vroom we world	M
#dale at going keep merchandise now on party right sale the	M
#emerge15 available; are early for never over start student tickets to the taking too world	M
#shanghai #china #mrworldwide an for incredible life night of party really thank the were you	M
#shanghai #mrworldwide #teampitbull #china is it in last let\u2019s make night our remember show tonight to	M
#globalization #pitbull #fun always check dale! having my new out single with we're	M
are by code every guided gentlemen have lessons life lives me of some that these the throughout	M
#china #guangzhou #teampitbull fun! have is night tonight to your	M
#china #beijing at definitely enjoys enjoyed hall i\u2019m life, performing someone workers who yesterday	M
#emerge15 did it interview last my now: see watch year you	M
#kobe #tokyo #nagoya, #mrworldwide and dale! forward fun it look returning soon thank was you	M
#japan #mrworldwide #makuharimesse dale! level new taking tonight to we whole	M
#mrworldwide #nagoya #tokyo amazing at are experience last night now party taking to the we	M
a$$ box bad cottons fulllllllllll! hopefully is of sooooo senator voicemail	F
cyrus cotton's is in miley sh*t some stir tom to trying up	F
and about amp; equality freedom is important me so to the why	F
40% are breaks did heart have homeless i'd know lgbt love may my noticed of so to talk youth you your	F
!!!! (202) 224-2353 amp; cotton call express freedom hippies happy is important let's our some shit stir senator to up! us why	F
\u201cperspective\u201d \u201cin being cuz community crime cotton for gay get hang iran needs of senator the to they thinks you	F
about amp; ended future just music more of started talking the up w\/	F
anything a$$! be being bad believing conned exactly else indianas into it is rfra thank than wont we what yiew	F
and apple amp; country cook equality! for forward keeping moving standing this tim thank up yiew you	F
amp; connection! communication for forgot how has love media much reasons social some serious these twitter	F
#happyhippies amp; are be can do going help how involved kids lijuan like more to what you	F
#equality	F
and about all got him moment my of people precious ricky share the thinking to with who	F
#diaryofadirtyhippie fuck first in official photozzzzz yeah!	F
#happyhippiepresents #laurajane #adam	F
\"rap all about do for god\ how inspiration is know more read rap really to the	M
\"just \"slim born don't eminem fuck\ give how initials.\ on old read slim shady, shady the was	M
#lovestory album best cut friend forthcoming listen our proud present to	M
at changed check is, life my name on out song that the thoughts what	M
#lovestory 4.21 american check drops out you	M
and about after checking check go had my on of out some them to tracks talk	M
been i've in new of on peek some sneak stuff the trailer working	M
#notafraid tomorrow	M
amp; albums big detroit from for grab music! my people show some week	M
deserve day for great had hope it lad legend much rovers so thank what you	M
!! experience game grown i've loved lads most of that those up what wow watching	M
it shiiiiiiiiiting	M
!! also been copps for honour inviting legend me massive play play! thank to us what you you've	M
!! be can't day great gonna play to today wait	M
#savechloe itv on tough viewing	M
!! broken cold house hot in love showers the waters	M
!! bbq get loving out this weather your	M
2nd caught game half madrid of the	M
another day productive super today	M
album day great get go it's jamie's siiiiiiick today writing	M
noooo, niall ooohh	M
around dippers got have haha heartbroken idiotic i'm kick let's move mozzarella of rid still the that they very	M
!! been dominos fat get gonna home order toooo when	M
all boy banter he's haha just my	M
debatable hahaha still	M
!! amazing been big but forward gonna has looking leg miss new on of really record start shows to this tour time the working	M
authentic curry chicken, etc., go here! in it's if queens, right roti, some trinidadian want	F
bag by chanel coming jacket pinkprints sneakers: soon the	F
:) classic chanel for having jacket jordan love me new the thank this to team you	F
just posted	F
hmmmm loud out perform should thinkin tonight what	F
#pinkprintjordans about are but custom every girl male on rapper shit to when you're your	F
mommy my	F
#heymama #12 #videocomingsoon #1 100 dance, itunes no on out, performance tv top us video	F
area! doing dope for go her in if lady_smurf_ miami my nails see she's thanks the you're	F
\ud83d\udc9b\ud83d\udc8e\ud83d\udc8d\ud83d\ude0d\ud83d\ude0d\ud83d\ude0d\ud83d\ude0d\ud83d\ude0d\ud83d\ude4c\ud83d\ude48	F
\ud83d\udc8d\ud83d\udc9b\ud83d\udc8e i'll it later post	F
7th at can de festival france!!!! july me nimes now on purchase see tickets to the you	F
and for supporting thank you	F
#fly coming for out support thx to	F
#fly and for sharing thank you	F
fly for glad i'm like lots my of thanks video xo you	F
#itunes awe...thanks fly girl!\u201d good i'm job loving much new song so	F
#whatnowtour available area amp; england for is invading info more new now...for shows tickets the	M
ball best damn handle have it's irving in kyrie like looks might on the	M
#whatnowtour #dopepic	M
4\/21 4\/22 as asap! amp; about charleston get greensboro hit in i'm mentioned my nc on previous sc text to tickets your	M
#whatnowtour 4\/22 available coliseum charleston invades my north on tickets the	M
#whatnowtour 4\/21 amp; for greensboro headed info i'm my nc on show tickets way your	M
#mohegansuncasino before my storm sanctuary....calm the	M
#tailoredman #comedicrockstarshit #dopepic styled	M
#whatnow 4\/21 bringing by charleston carolina followed greensboro is im my nc next on stop sc tour week..1st	M
amp; been buffalo....2 crowds!!!! city....i've coming honestly love out sold shows thank this unbelievable you	M
!! #tamojunto abs	M
!! \ud83d\udc4a bonito faltar n\u00e3o podia t\u00e1 voc\u00ea valeu	M
aben\u00e7oe deus nos proteja que	M
!! valeu	M
#tamojunto gracias	M
curiosa que sobre	M
atividades as coisa come\u00e7aram com deixa eu falar liga no pra sabendo se t\u00e3o uma voc\u00eas...j\u00e1	M
hahaha	M
happy	M
aben\u00e7oe deus nos proteja que	M
deixa eu hein ligar mundo pra seguindo todo	M
!! as a\u00ed atividades acompanhando come\u00e7ou crian\u00e7as com galera hoje primeiras t\u00e1	M
aben\u00e7oe deus nos proteja que	M
\"lima \u26bd\u26bd \"professores\ belarmino chama dos instituto me na neymar nen\u00ea pr\u00f3xima saudade visitam visita	M
aben\u00e7oe deus nos proteja que	M
grude meu	M
poker	M
birthday for love thank the you	F
thank you	F
be better cogsworth couldn't for person there welcome!	F
be by first have killed love photographed started to working would work! when you your	F
amazing are these	F
and are believes dear enough elisa good in tom, you	F
and about able all been concentrate doing heard hope haven't joni morning ok so she's to	F
amazing board have on so to you	F
big deal no	F
7pm don't from face familiar might miss on see tonight you	F
because did day everyone great had hope international meant of this tweet to women's yesterday you	F
#iwd2015 #heforshe aren't cool for is much no so thank there way yesterday you	F
#bluestone42 but here hilarious he is in looks on so serious very watch	F
\u2764\ufe0f bonjour gaston! welcome!	F
aboard be beast!!! could happy man more not that this welcome will	F
another crazy day out sold	M
;) \"the check it just on out selection\ updated	M
10 and already actually as billboard dance in number one re said top the us we yes	M
#marbella 1st august! back david guetta is in if playing you\u00b4re	M
beautiful so	M
beautiful canyon grand in maverickhelicopters most of one sick thing the trip wow with	M
check guys these	M
jolt little nice that was	M
follow me on	M
now| |live	M
now| |live	M
is song	M
bad is pretty this	M
i'm	M
hygiene is what your	M
is there vayner	M
community! dr explains for nirav network nextdoor: phil private supporting social tolia	M
feedback love on would your	M
and day entrepreneurs for help my over spark twitter take young	M
become existed for have if myself member searching this think would when was	M
enough help have kickstarter me money more my next please raise see to visit week you	M
again, court em fake in i'm kind of putting see sloppiness that	M
call me son thanks,	M
40 ago, years	M
all amanda confused got happens knox me the with you	M
can't just limit myself one to	M
freak jesus me rapture takes til the	M
couple guys no of to up who were	M
accepted challenge in know my only sign sing songs that	M
as breaded comes care don't from hooters, it long or	M
all at best fingers his him in kept miss separate spinning times the while women	M
but before dad great kind my of, question, up woke	M
don't how in know, many	M
at nickel see the yes! you	M
coffee don't drink hang or out with	M
easier it lot once was	M
good	M
and chooses computer christopher for gratifies invented me named that	M
and after could clean class erasers if know maybe stay the what you	M
aren't going if things	M
about focus funnier instead late making my night on one of show stupid state tweeting things the would wish writers	M
and cuts football goes he middle my now out play prison son say to the wants	M
\u201cas county ex-governor for goes is in island know of one president.\u00a0you rhode running so say, they the what	M
\u201cmy boat.\u201d by everyone, feed got hot hijacked in is it lt;&lt;&lt;&lt; my rifle somali sorry, this twitter wet	M
do don't doug i'll just send whatever want you	M
armenia asked change he kardashians met name of president them to their the with	M
20\/20 and an candidate him is legalizing making marijuana, ophthalmologist only pro paul rand supports the who	M
announced did for is man, not president running see she that	M
15 40 among at can don't expendables gop guns hopefuls if least make own presidential still top their them they the win,	M
ass centipede do get have human in kiss new to the whose	M
\u201chold apple asks can\u2019t for me my on scrolling,\u201d say someone to time the when wait	M
\u201cbetter can\u2019t call for is men mad of spin-off, there talk wait	M
#gimmefive and amp; ball challenge crushed in is me now the your	M
#gimmefive (i\u2019d 11 2nite arms accepted but been cramped challenge has more, my on pm this tbs typing write while your	M
all after been friends go had happy if just jewish let my pharaoh, passover to three would've you	M
(i am course don he is of referring risen! to	M
all catholic is know out priests shout super there, to the tomorrow your	M
\u201cjambalaya\u201d don\u2019t hope made mind say that to you	M
bullshit count had i've never sperm that that's	M
await, be claws dame his hugh judy jackman last movie next playing says time the will wolverine x-men your	M
before heading r&amp;r to time vegas!	F
#1toinfinity #infinity available april amp; for includes new now on out pre-order single	F
awesome amazing busy, canada calgary can't delicious fun, food go had hotel, in land of people, quick swank trip to the wait	M
as b'way! crazy i'm just on of opens proud tonight	M
#conman and any be brilliantpants future love: project starring this will	M
2nd best belated congrats epic for her husband in of portrayal to yitzhak year+	M
and bunnies burtka-harris easter from happy lil one the	M
#goodfriday even enjoy for it's makes nyc of raining, though the very warm weather your	M
ago and date eleven good great happy have kids, married, now on two today, times we're went with years	M
#besttastinglight can't err, ever guarantee heineken is light personally tasted the you\u2019ve	M
anniversary, claws! cat glad has her happy old one still see to the year	M
last night\u201d on puzzle th_t'_ were you	M
\"a about as curiosity\", creative, do fantastic intelligent, it's it love: put podcast show this they the witty	M
called endorsements, finding i'm just keep love not new paid random recommend stuff so, starting thing this things to	M
advance an for gets helping hope he in my out!\u201d plezsh thanks	M
1st 1) 2) 3) abq animal about chile dolphin dimes\u201d do fav green learned miss magic nickels to trick the what what's you	M
4th \"famous chose from for few grade his has he my nm\ okay people paper questions son you...\u201d you	M
#breakingborders and cooking for films globe meals opposing people travels their the views watch with	M
and brilliant, bring classy excited had kind last night on stellar show this time to the with	M
and all ant based behind dec's in london loving my night new of producing show, soaking scenes saturday the variety	M
and amp; at cast congrats creative done entire for first job last night! of preview team the their well	M
anniversary blast celebrating had last the year	F
#therealthing 1st but can ep get my of premieres tonight,	F
#voiceresults #getthelook last show	F
#getthelook #voicetop12 last show	F
#teamxtina \ud83d\udc4f\ud83d\udc4f\ud83d\udc4f give slayed them tonight! votes! your	F
#acmawards50 \ud83d\ude4c entertainer girl help my of the vote win year!	F
episode first here\u2019s me my next on of peek premieres sneak wed	F
#voiceresults #getthelook last show	F
#voiceplayoffs get last look the	F
#thevoiceofficialapp! #teamxtina \ud83d\ude0d amp; by it now proud phone, slayed so tonight! text, vote	F
and city came did go is it mega not surat to what	M
am are from fixed getting game me my no on onwards pm saying since seat the wrong you	M
!!! am from fixed game hahahahaha meant my on pm started since sunday seat this the	M
birthday happy	M
love to you	M
censor gets the what	M
be fine	M
game what yes	M
great	M
hai	M
and same to	M
!! -\ 1839 but censor funny here is it might message meaning new on something, simple: the take whole when you	M
!! 1839 and else fixed go is ipl lot pm since something still this to year	M
-the 1839 \nof \nare amp; enemies human happiness pain two	M
haha learn to took while	M
bahut galat hai ho oh phaimi unko	M
and did its yes	M
and by big corporate corruption for government generated greed is media need pharma profitiers sponsored that terror the vaccine we	M
and all are be don't feel free is no see see, there things that two you	M
don't get hung on semantics too up	M
and an always arrive by created didn't everywhere ego forever here is idea in leaving not space, time the we're we you're	M
and become dissatisfaction doesn't giant get has is megamall make more neighbor only selling sure they're thing the world your	M
break.this black cause hole may of panic.i'll personality resurface sorts.don't takin twt vacuum,a when	M
be chips couch eating interesting i'm look! my more not on oscars plunked spirit than the while will	M
40th and all among anniversary be comic gens greatest grateful included last me of on putting snl so talent there the	M
\"daddy block eventually icloud out sun?\ the will	M
#happynowyear 2015, 7! count competition celebrating edge get gonna in i'm just muahaha! not on of really start to the	M
#happynowyear and all countdown don't from for future freedom fear itself illusion of past regrets, the time wish wait you	M
are don't feeling own ones powerless real slaves the us who worry	M
(:^\u2022)( )( \u2022 great snowman!	M
enough for forgive long live loving may not parents to you your	M
avatar smell white	M
bacon helloooo oliver! shakin there, what's	M
150 balls but by dispair, dough fried i'm kids lost murdered sorry taliban the unimaginable were your you yesterday,creating	M
am at clue, gave jokes live laugh some saltwater the who wonder you	M
\u2013 abc! me on tonight watch	M
brother catch his hit me my new on performing single tonight with	M
amp; collaboration grammy guetta kai konfuzed museum pascal	M
2nd home in join las me may my night new saturday tickets vegas your	M
and all asking by be disobeying for give god his help him it if living little myself more try to will	M
and back coming moon never to the	M
#vevocertified #teambreezy 10th became flame just my new thx to video	M
able can everything fall great humble it's i'm lot myself off often see track to when yourself	M
#ayo for fans making number on rhythmic record radio! thank to the you	M
and an amazing brother for my night! thank to you	M
#fanofafanthealbum! #teambreezy be for fans let next pick single to the voice we want your	M
madness: march	M
#fanofafanthealbum #ayo and breezy download keep on requesting team	M
#ayo get let's on this watch	M
#kuwtk 9\/8c all at don\u2019t forget is new on tonight	F
#kuwtk 10th airs are another believe can\u2019t in new our still season\u2026 we	F
happens in stays vegas what	F
9\/8c at catch down e! going it\u2019s on tonight! up us with	F
bodysuit, by: balmain ford hair last look makeup night's skirt, shoes tom wolford	F
about last	F
about last	F
#kuwtk brand don\u2019t forget guys! is morning new that	F
bound birthday celebrations\u2026 for get let\u2019s party this vegas	F
birthday from favorite flowers my men! two	F
beautiful birthday	F
birthday best card ever from koko loco my	F
bound birthday celebrations\u2026 for get let\u2019s party this vegas	F
#fbf \ud83d\udcf7 ago by birthday my ten to tomorrow years	F
and all energy from have i'm lyfe_tea loving more my natural results seeing teatox! the way	F
and all energy from have i'm lyfe_tea loving more my natural results seeing teatox! the way	F
and auction ebay for good happy is live! my shopping	F
day.\nanother day humanitarian is to today world	F
#chimeforchange all am be benefit concert empowerment for great honored initiative in nbc now of part this to the tune	F
#whd2012 doing day else for good, humanitarian i\u2019m join me! someone somewhere, something this world	F
#iwashere all doing! it starts with	F
#iwashere 19th away!\naugust act be beyonce'.\nworld days day hello, humanitarian is its kindness of what will your	F
and b!\ni'm been excited for finally hey it's invite my new ready so to working\nhard, we've world, you	F
9\/8c at brand don\u2019t episode e! miss new on tonight	F
#kuwtk for fun ready some you	F
#kuwtk me who\u2019s with watching	F
#kuwtk brand going miss not new on to tonight want you\u2019re	F
#kuwtk happy sunday,	F
coachella	F
love you	F
alert bad bitch	F
birthday chicks ever favorite happy i've it's most met monotone my of one to things the	F
and babe, everything has i'm love manifest only positive pass smile sorry sucked trying to things try week will your	F
all almost believe cry continue deeply! happiness! in me made of power prayer prayer! so to this the we will with	F
lol	F
amazing addicted be but horrible it's to thing	F
are bless god love?!?! ok strong! so you're you	F
\ud83d\udc8b\ud83d\udc8b and beautiful birthday birthday!!! day!! ever! have happy incredible love lots may most on of smiles the your you	F
asked amp; btwn bosses friendly it of pic post to this things thought until was were where	M
adding american arrived just morn...vid new oxygen on track this the	M
alarms by delete have iphone...must my never on set thousand the up	M
#savejoey or turn: your	M
and is live on that tv we're why	M
and area cross demi, from fan girl in if june named nyc off of to ur want you'll	M
happy	M
boss bring he's in kent's muhtar office of out party town, while	M
but by dropped easy errwhere free find hq..secret muhtar not recipe refreshments thx	M
thats weird	M
jetlag no one said yay	M
and amount aside for good haven't it need of set seen time to thats watching why yet,	M
after boardwalk empire finally myself of starting telling years	M
and actually ain't are coz down discuss for gonna have life makes someone sit tea taking to thug video, we what	M
all god help of	M
coz fuckin its that's	M
one	M
down i'm so with	M
just posted	M
finally got helium	M
again, are first he on once play radio song that to the you	M
dafuq is	M
but damn ralphie she tony, was	M
#killingit #coachellacrew #yumatent \ud83c\udf89\ud83c\udf89\ud83c\udf89 at backstage coachella music	M
#lovemylife \ud83c\udfb6\ud83c\udfb6\ud83d\udc78\ud83c\udfb6\ud83c\udfb6 saharah	M
\ud83c\udf89\ud83c\udf89\ud83c\udf89 saharah	M
#highoffmylove 4th! all can't date everyone! earlier! for great have hey hear is i'm may new news! releasing release to the wait you	M
#currentmood	M
#killingit \ud83c\udf08\ud83c\udfc7\ud83c\udf08 coachella music my riding thru unicorn	M
\ud83c\udf08\ud83c\udfc7\ud83c\udf08 at coachella found garden rose unicorn vip	M
#coachellabutterfly \ud83c\udf08 saharah	M
\ud83c\udfb6\ud83d\udc83\ud83c\udfb6 dance fun in! love much my skirt! so to	M
#family \ud83c\udf34\ud83c\udfb6\ud83d\udc78\ud83d\udc69\ud83c\udfb6\ud83c\udf34 \u2764\ufe0f at beautiful coachella cousin loved my seeing	M
#pizzatime \ud83c\udf55\ud83c\udf55\ud83c\udf55 coachella music	M
#coachellacrew #round2 \ud83c\udf34\ud83c\udfb6\ud83d\udc78\ud83d\udc71\ud83d\udc69\ud83c\udfb6\ud83c\udf34 saharah	M
escalator in riding the up	M
#maximmagazine \ud83d\udc96 can't did for love shot summer! this willycamden with wait	M
#contesttime! amp; billboard coachella if my on see takes this to way whoever weekend you're your	M
choose from, great many options picked so that there to the winners were	M
#heroes against animal cause fight in illegal love of our poaching supporting this their veterans	M
all favorite my on of time	M
#nbaplayoffs2015 #awesomeandyouknowit and	M
are being hong is in kong nice people sun shining the today\u2026 technology wonderful	M
by dave five i'm listening to take	M
amp; by bob divertimento i'm james keiko listening to	M
for spreading the thanks	M
love stevie...\nhe's still	M
all for it in just on real robbed! robbed....we see she twitter time to us voting wasn't was weren't	M
knows know...i know...you she's twitter we winner	M
twitter the we wish way was	M
collection everything from for faves my omgah shop target the want	F
\ud83d\udc97	F
\/\/ and aj coming danni for get in june ready	F
awesome!!!! because it's it just on turn	F
\ud83d\ude09 camera clipped coming for in june lights my near new promo shoot series to tv today,	F
can't stop won't	F
#clipped filming on set with	F
#clipped coming for first in june! my new official show to the trailer	F
an earthquake game of or playing thrones that was	F
and back bangs had it littles me my sis throwing to when were	F
is my song this	F
can't every for guys me me! much my new series see so to thanks where watching watch with wait you'll you	F
#funfact and always as being behind camera camera, front in loved of the working well with	F
#funfact: #youngandhungry excited film jonathan lol scene stripping so to the was	F
#youngandhungry gabi loved poor plot twist! the	F
#youngandhungry and always crop colors knows love my matching skirt top to what with work	F
#youngandhungry, aka, anything cook do ingredients much new pretty when with you're you'll	F
can earth effects from focusing final film how is nature on of our protect restoration the	M
52, back campaign excited find to	M
#virunga appian amp; company docs exciting from important like my news produce production to way	M
big create for largest let\u2019s marine make opportunity reality! reserve this to the uk world\u2019s	M
#\u0e0a\u0e0a\u0e49\u0e32\u0e07\u0e0a\u0e48\u0e27\u0e22\u0e0a\u0e49\u0e32\u0e07 citizens demanding end elephants: ivory let's of protect support trade to the thai	M
#virunga #churchofengland \u00a33m firm for fears gorilla haven in mining may over sell stake	M
#netflix #virunga and all at esp joined last night, president screening to the thanks who	M
from here: images more nominee oscar	M
best congratulations documentary for feature nomination on oscar your	M
check director einsiedel great in interview orlando out this von with	M
\u201cthe about against amp; book battle climate check his hockey out stick the wars\u201d	M
34 baby elephants exporting help! is need stand tell wild your zimbabwe	M
#climate amp; are action businesses cities do for governments pledging same to time the	M
amp; are boys doesn\u2019t get go\u2026.if kkrian murderous! other one to team! together the will\u2026.thats way you	M
be boys!!! celebrate daughter go huge kkr\u2026.will love my pune!!!! should with you	M
and evening for hospitality it killed my such shoes thank ur warm your	M
bring doing every face\u2026.keep great happy last night see smile to the was you	M
are bless hope keeping thank well you	M
congratulations it lived life my nice on really see to too well was you	M
allah at asian bless cool dinner him is kid may so this time the	M
amp; awards asian boy bilb cool done great gurinder\u2019s hav job kiran marvellous naughty on paul so zayn	M
cold feel like london mornings much of putting pic so that the up vague with	M
all am can\u2019t for fun good glad having if join such thank to wait you	M
birthday happy lil to the	M
all been cities dubrovnic delhi hopping have kolkata london mumbai now off over realised suddenly to world	M
my see	M
all amp; best cool for having hotel have is it me nice\u2026and really set thanx the up very was you	M
at amp; by bhavna done death dilwale done! for gauri, goa great hollywood job moms met my namaaz nandi now planet return team well	M
ambassador an becos but became cos done for game hard has like no1 needed not no.1 over off paid the ur work well yrs	M
amp; bigness delhi forget how is life of rain\u2026.makes reminds spectacular smallness the	M
airplane because blanket don't face go head moment over put see sleep slobbing that to want your	F
amp; b4-bed didn't have it in look liking makeup mirror moment that the ur wish when wash	F
and body but cuz concrete crashing from good goes got hand moment phone relaxes slips to that the ur	F
ass are big but eggs hour hungry have later morning omelette some scrambled so that with you	F
at bathroom contemplate damn day go just nap on pretending really so to tired that the work, you're you	F
as but day get heck late magically on or school that to up work wake you	F
2day.i 3rdslice awardshows eatless get gotta icecream it me most preparing4 scoop together...w\/ when	F
2x cheese could cream flavor frosting oh so taste toothpaste wish were yes! you	F
(ok, beyond call hours me off that tymeleon was	F
no	F
age boo! color fierce heck looks no, natural purrrrty rock skin that to tanning will young your	F
#antm better doggie face! is my that than werkin	F
amp; damn, fierce goddess love love, patron some serious there! that's	F
does great! looks see so she that	F
sees ty	F
has secret the	F
26th, april daytime emmys! hosting sunday, tyty's the	F
and azealia banks call elizabeth ever hang, have hung if out.\u201d should to we wonder	F
at today	F
coming feeling is i'm moment on ooh, strong so the urge	F
nos	M
emociones gracias las por	M
(aqu\u00ed) d\u00eda despeine el empieza os que	M
buenas gente mi noches	M
breves de el estreno en la mucha segunda temporada	M
disfrutando en esta estamos grandes noche qu\u00e9 voces	M
#lavoz4 arrancamos con en	M
buen coraz\u00f3n deja eduardo fu\u00e9 galeano gran inteligente maestro nos se un viaje	M
ese me subo yo	M
#sirope cada cerca\u2026 contra de d\u00eda del dejo el estamos la m\u00e1s os tracklist vinilo	M
30 all\u00ed abril\ de el en enteraste estar\u00e1 los nos tambi\u00e9n	M
amazing are both films guys, hey have in long most of releasing seen that time two the tomorrow	M
best check films have in long of one out seen time the	M
and australia for hard indian luck played semis thank taking to team the us well you	M
yadav!	M
are desperately good looking need not things we	M
hona haar haathon hi india ke ki likhi new toh tha waise yeh zealand	M
elliot hats match!!!! off steered that to the what way	M
and away am brief deeply distraught has hearing in jordan on passed shocked suzette that time the	M
done india! one step well	M
shikhar, thank virat, you	M
address chakki de ka shikhar,	M
hard luck virat	M
fire!!! on shikhar-kohli	M
and condolences forever family generosity heartfelt he me my showed stay to that the will with warmth	M
25 and balachander entire evenings humble in mr most memorable my man of one what with was years	M
23rd away balachander been cinema contribution day for his has immense indian mr on passed sad to	M
awake aaya can\u2019t for few guys, go hours i\u2019m just now pk rise sun sleep to the wide wait	M
just posted	M
just posted	M
just posted	M
just posted	M
just posted	M
jammin right	M
just posted	M
#wellnessretreat #djsnoopadelic after live official party s\/o tonite	M
#faded checc neff out production s\/o track tha	M
just posted	M
43 day happy troy	M
just posted	M
just posted	M
just posted	M
just posted	M
for getting is ready todd	M
just posted	M
just posted	M
just posted	M
just posted	M
abuelo con ech\u00f3 el ella esta epica gay hijo le por respondi\u00f3 ser su	M
#newzealand! for thanks	M
#zodiaco aventureros emocional inclusive nivel riesgos tomemos	M
#newzealand do for in i'm just let's landed ready show! tonight's wellington	M
enjoyed glad i'm	M
love our	M
desesperen estoy loco mismo no por se tambi\u00e9n volver yo ya	M
#oneworldtour #auckland 20:30nzst aqu\u00ed en gente!compartir\u00e9 los las minutos mi primeros ustedes vivo	M
#oneworldtour #newzealand #auckland 1st 20:30 at for follow gang, hey kickoff look me on periscope	M
#rickyaqqe conmigo de el estar estado gracias haber lanzamiento por revive siempre	M
be bring coffee, happy: me make to	M
by: my photo	M
atr\u00e1s ni para tomar	M
and ahead go hey	M
\"celibacy \n absurd blood ban challenge\ donation fda's gay on takes the	M
#disparoalcorazon cantando en espero estar\u00e9 gente!!! hoy los lo mi no pierdan!!! se	M
#miami 8am, audition at begins come call downtown for guys hilton in last registration show to the today us your	M
esa es inolvidable noche recordar revivamos v\u00e9anlo vivir volver	M
#audicioneslabanda, #miami! \u00bflistos \u00a1\u00daltima asistir de downtown el en hilton las ma\u00f1ana oportunidad	M
and excited, for humbled motivated the	M
new	M
featuring mensa mad vic	M
\u201copportunities\ and clear focus on of steer to want	M
and akira all are be blood equally favorite movies my of there will	M
don\u2019t die even go get heaven people to who wanna	M
like really this	M
and league!!! me summer ty	M
available at edition following for free print season the zine	M
and an are execution for gifts is inspiration kendrick message meaning, spirit thank to the vibrations your you	M
and allan decided featuring first it kingdom make official paul to theophilus the video	M
brits captured energy felt of performance the	M
and album!!! back by day for finally in kendrick\u2019s listening my music new studio\u2026 starting thank to the you	M
i\u2019m so	M
baby congrats last on premiere show the	M
assim anuncio anos bola! carinho: com de dez fizeram fazer gol kkkk mais m\u00e1gica! minha obrigado presenteado ser tarde tanto tds t\u00e3o	M
amanh\u00e3! concentrado de jogo pro	M
2010 al camp en inolvidable jugando maravillosa mi momento nou para que regreso recepci\u00f3n tuve	M
congrats freestyle!! great going in lot my of quality showing this video,	M
categoria do freestyle!! muito muita mandando no nesse tamo v\u00eddeo,	M
!!! control can do full lol\npost picture this with who your	M
#championthematch a\u00ed de jogo mas muito mandando no pro palpite qual seedorf seu	M
cumple de extra\u00f1o feliz gran hermano!! mejor mi para te todo ti!	M
anos! ag\u00eancia comunica\u00e7\u00e3o cuida da faz imagem minha que	M
#ronaldinhoenmexico #siempregallos 2015! assist\u00eancias com em feliz l\u00edder muito ser vit\u00f3ria	M
#dibre \u00e9 awesome!!! bom bueno!!! demais!!! es ganhar ganar is muy winning	M
ao bom conquistas!! de dia grande irm\u00e3o meu muitas nesse pra parceiro parab\u00e9ns tudo ti	M
#tbt bom dos lembrar momentos na que sempre sele\u00e7\u00e3o! tive	M
#siempregallos	M
alegria afilhada cara com do de da feliz filho minha meu olha os ovos para p\u00e1scoa! p\u00e1scoa todos	M
aben\u00e7oada! de gustavo!! muito melhor parab\u00c9ns, p\u00e1scoa tudo uma	M
be good luck	M
#xfactor 19 and april auditions are birmingham club city could change football in know...this never open today you your	M
again britains even for got is last night once show thank talent think watching you	M
are how	M
act do history! itv love make on one returns this tonight will	M
are cheerleader demand due forward like moving massive of omi release sunday to this thought the we would you	M
clip down factor he it just naughty on presenting saying saw this turned the video week watch was	M
and apologise amanda in to	M
beautiful what	M
8-10am auditions at chicago courtyard come downtown, from good is marriott open out registration to the tomorrow up! you\u2019re	M
and on something together we work will	M
and an amazing been craziness dermot factor great guy held has he is most on of presenter real time together the	M
at office quiet this the week	M
goodnight	M
all always as amazing boys fans great have shown support talent to things the when your you	M
by defined is not strength sometimes	M
brilliant congrats did he last night thought watched	M
from miami	M
addressed at bjp my mps of sharing the today video workshop	M
and from france, germany my nation photos sharing some to tour	M
and being dear fine host, human special to thanks very wonderful	M
big canada enhance further immense india-canada leave of people satisfaction ties to this the thanks visit will with	M
amp; at gurudwara in khalsa prayed the vancouver,	M
for friends goodbye leaving our saying to while	M
at amp; canada diwan for final gurudwara is khalsa laxmi leg leaving my narain offer of prayers temple the visit vancouver, which will	M
182 ai all board in lost lives on remember their those we who	M
amp; are dear inspiring touching words your	M
for kind thanks your	M
meeting wonderful was	M
and absolutely! amp; are both benefitting even further, grow nations of our people set strong to ties the	M
for thank you	M
and always cherish coming enthusiasm for in thank the welcome will warm you	M
memorable thank was you!	M
at community here is indian in my of programme speech the video	M
at community experience indian thank toronto! the unforgettable you	M
for leaving	M
ask abt chota can handle her hota hiral's jab kahbi kabhi me maota nahi netwrk twitter to toh tell wat	M
about ace bring brand casa esteemed excited fendi for furniture joining maison to the	M
abb aah devi dubli dekh ho ko kamaal karti lo patli sonakshi wah! yaar yakeen ya,	M
arpita completed on twitter yrs	M
batao flying feathers gin iss parindey toh	M
aur aap bhi ko sub thank	M
also counting dubli devi followers had in joining me play patli part she sorry, small sonakshi twitter to thx too,	M
arbaaz on thx twitter! to yrs	M
aur ek	M
for you	M
come me on watching zinta	M
being been congratulations deserved, for he's nominated on of pfa player to the well year	M
better family nothing tbt time than	M
final girls in manchester netball of semi support this team their thunder the	M
always brilliant derby fans important nice to thanks the today who were win	M
derbies favourite far here's i've in moments manchester my played so the	M
yes	M
any chance golf of showing some sky	M
and career can't for good get grand go later luck masters slam that the wait	M
#saturdaynighttakeaway and ant at dec filming good had it little laugh on tomorrow watch with	M
and met my new partners strike they're	M
birthday coleen day have hope happy lovely my to wife you	M
big coming forward getting games involved looking some these to up	M
and against bad draw enough first good half italy last never night not plan to the wasn't went	M
all away england for followers! giving i've i'm million reached shirt signed say to thanks	M
\u2764\ufe0f\u2764\ufe0f	F
aben\u00e7oe amor! bubbles de deus dessa prop\u00f3sito, seguidores vida vcs,	F
amores aben\u00e7oe ainda deus mais! meus	F
acaba amada ao arthur, anivers\u00e1rio chegar com de faz junto minha meu novo sobrinho, sobrinho	F
18\/04, 2015, alegria alta! ano, cora\u00e7\u00e3o dia em gratid\u00e3o! meu me no passando t\u00f4 transborda td	F
assista agora claudia com cart\u00f3rio, de especial equipe leitte part sucesso	F
#cart\u00f3rio claudia confira clipe com cart\u00f3rio, de especial equipe leitte novo participa\u00e7\u00e3o	F
assista agora: cart\u00f3rio equipe no perdeu show v\u00eddeo	F
equipe hoje, n\u00e3o no perca show! v\u00eddeo	F
#jequiti #secret \u00e9 by da fragr\u00e2ncia minha nome nova	F
;-) a\u00ed! breve em mais novidade tem vindo	F
#cartorionotvz \u00c9 de gostaram pra voc\u00eas voc\u00eas!	F
kkkkkkkkkkk	F
a\u00ed achou apareceram bolhas clipe no quem se v\u00e1rios	F
#cartorionotvz assistir com do estreia meus muito massa	F
#saturdaynightonline! 9pm at for left my next questions submit sat to week with	F
boston! eat flying for good plane question: reads some should serious to the we where	F
1234 body come do dreams ever full feist's i've since suit saw true video, wanted	F
and incredible story some	F
#ireallylikeyou and between before exchange message night shot text the we	F
#snlrehearsal \"show all i'm if me me, that\ want you	F
advantage been break da for girls heaven having it's in japan lil me my took trip we with	F
blossoms bloom cherry here in japan our of one only perfectly! somehow timed trip week we	F
it's just love like not you	F
can't giggling guy is in ok passenger stop seat the	F
buddies here made magic my some talented very	F
21st by better belong build century future humanity hands is in of opportunity training to the those who with	M
and are basis friends grows if kind made on of only to the trust you	M
at approach fruitless is it important people solving school that to teach violence young	M
clear happiness it\u2019s is of source that the ultimate	M
anger coexist characteristic cannot is inner of peace, principal the which with	M
and able better calm, find is joyful live mind of our peace to we\u2019re when	M
and able atmosphere an be beings, create concern for harmony have happiness, if of other real respect to we we\u2019ll	M
and brings beneficial best enables human is it intelligence; judge of one our qualities to us what	M
and attitude compassionate daily for good holistic helps health in it\u2019s keep lives, mindfulness, mind; more of our peace us	M
business business, compassion everyone\u2019s human is it important it\u2019s just know not of question religious; to the	M
and achieved basis between balance love material need on of progress, spiritual strike to the we	M
and anger can destructive effects from of only protect patience the tolerance us	M
calls can determination everyone for far it if more non-violence, only open peaceful practise succeed, to the will way you	M
and are affection compassion daily indispensable in	M
and as altruism be business, competition driving desire force for idealistic it in just may not sound, should the	M
an behave compassion commitment change doesn\u2019t emotional firm founded it\u2019s isn\u2019t if just on others reason, response, true which	M
and always but courage, determination, humble, lead modest remain self-confidence success, should to we	M
and an aspect also for it\u2019s is not of only others\u2019 reconciliation rights respect showing source the views	M
and always difficulties helps it, irritate important, is it overcome small things tolerance us without we	M
be but calm development develop gives happy lastingly minds material need only our pleasure, sensory to us we	M
compa\u00f1eros grande hacia important\u00edsimos! la m\u00e1s paso puntos qu\u00e9 un	M
apoyo bien casa! de descartar estoy en for\u00e7a gracias haremos la los lesi\u00f3n! mensajes ma\u00f1ana para por pruebas todos vuelta	M
\u00faltimo antes con de del el en entrenamiento for\u00e7a ma\u00f1ana!! partidazo	M
#teaminiesta contra el espera monstro nos preparado partidazo psg! un	M
abierto con campus dejo el hemos hola inscripci\u00f3n la link mi os para toda todos, ya	M
ahora casa champions!!! de este empate for\u00e7a hay l\u00e1stima que seguir!!!! vuelta	M
buenas de espero fin gran noches que semana! sea un	M
at can from now on stay whenever want you	M
alojar ahora de en partir podr\u00e1s que quieras siempre te	M
seguimos sumando victorias!grande	M
a\u00f1o bien contar campus el este lo mi muy novedades nos os pronto podr\u00e9 pasado pasamos sobre vamos	M
abril ahora dif\u00edcil de en m\u00e1s muy mes puntos preparando salida seguir una un	M
a\u00f1itos! casa cumple de hoy la muchas princesa	M
aqu\u00ed amigos botas colaborar con de el es la mis placer solidaria subasta ten\u00e9is un	M
el gracias importantes la nos peleando permiten puntos por plaza! primera que sevilla seguir tres	M
abrazo condolencias familiares fuerte muy mis noticia terrible todos un	M
hay momentos no olvidan que se	M
bar\u00e7a!!\n\nvamos bar\u00e7a!!\n\ncome for\u00e7a on	M
\u00daltimo antes bar\u00e7a!\n\nlast before clasico!! cl\u00e1sico de del entreno for\u00e7a ma\u00f1ana!! session tomorrow's training	M
flame	M
#wayf crew on see stoked to the	M
behind scenes the	M
are to talkin you	M
#movieawards all for seeing thanks tweets the your	M
#zacefron #davefranco amp; comedy kings list made of w\/	M
boys the	M
get	M
#zacefron #tbt #wayf dj dream in mode on one set track to throwback the	M
#zacefron #mtvmovieawards and are for: find guys he noms out received the today! up what	M
#oscars #hairspray awards amp; good luck producers show tonight to the watching	M
#theluckyone #teamze #zacefron #bts #fbf head his in logan play shaved to when	M
#teamze #zacefron early for getting never ready start to too	M
\"madonna\ killer mixtape, on repeat-	M
better dota than thanks!	M
300 and all bad congrats came games more! not paris supporters that to team the watch want with	M
amigo! adivina como cada de duros el en es equipo! han juegan jugado jugador no parece! qu\u00e9 qui\u00e9n son tan tranquilo ver	M
avui, conven\u00e7ut estic ho la per\u00f2 per que sento	M
cool did good job, office! you	M
acuerdo de totalmente	M
botas de d\u00f3nde est\u00e1n la las m\u00edticas negras toda	M
comencem! en estem	M
#airmaxday #airmax \u00bfqu\u00e9 airmax celebrar el llevar\u00e1s mis para tengo t\u00fa, ya zero	M
but goals, in it\u2019s manage need nice score to team well your you	M
\u00e9 aguento, domingo de divertido eu fez...mas isso jornal ja mundo muito n\u00e3o ontem...que sei	M
ao ai ah...e assistiu do epis\u00f3dio n\u00e3o para quem saltibum, segundo	M
#caldeir\u00e3o...ai assistir bundchen, brady, de da entrevista gisele marido n\u00e3o no ontem p\/ pode quem tom vai	M
11 \u00e9 ajuda anos bem...nunca corrente do de demais este menino precisa um	M
adoro bjs cada camera de esta galera! lenta novo! na obrigado sorriso!	M
ai bonito! com carinho! estar enorme foi hoje incr\u00edvel manh\u00e3! obrigado pela pelo rio valeu vcs	M
#caldeir\u00e3o do emocionante fez grava\u00e7\u00f5es hj linda marivaldo nas obrigado participa\u00e7\u00e3o stomp uma	M
#caldeir\u00e3o! amanh\u00e3! bem esta espero inteiro legal! no programa todos!	M
#umportodosetodosporum (rj) alo aparecer avenida at\u00e9 bem bonito cheguei de do entrega j\u00e1 maio na quem quiser rio sera vindo	M
#ficatanoar	M
live on	M
100 21 anos aos brasileiro do das entrar influentes lista mais mundo pela para pessoas	M
#caldeir\u00e3o 15 anos com ela h\u00e1 mat\u00e9ria para primeira que s\u00e1bado tem vem	M
#caldeir\u00e3o aos do estudio estiveram f\u00e3s hj no que tb, todos valeu, valeu	M
#caldeir\u00e3o aqui bastidores breve banda do em no nos programa recebendo	M
live on	M
live on	M
#caldeir\u00e3o hehehe...parabens	M
live on	M
\ud83d\udc4f\ud83c\udffc\ud83d\udc4f\ud83c\udffc\ud83d\udc4f\ud83c\udffc \ud83d\ude4f\ud83c\udffc\ud83d\ude4f\ud83c\udffc\ud83d\ude4f\ud83c\udffc audiencia! esses eu esquecerei! nunca obrigado pela que sao sabados todos	M
carla funk!! no segura thais uptown	M
\u00e9 ar! agora esse engracado!! jogo labial loucura muito no	M
\ud83d\ude02\ud83d\ude02\ud83d\ude02\ud83d\ude02 agora assistam!! da direito dos foda! historia!! impagaveis!! momentos melhores no pena ta um ver vale	M
#cristianoaraujonolegendarios fa kd os	M
\ud83d\ude02\ud83d\ude02 agora carlos de japones!! no roberto verdade!!	M
\u00e9 \"meu \"comuns\ ar artista! agora, colocando de esse fora lado\", lado no outro pra pessoas quadro que seu surpreendente! ta vem	M
\ud83d\ude31\ud83d\ude31 ao cantando!! com dancando ja lado menina mais meu no na outro parecida que vida!! vi vivo!!	M
aline agora araujo, cristiano cantando jorge juntos legendarios!! matheus no na rosa safadao vez wesley	M
brand check episode happy kuwtk new out sunday!	M
gorg is	M
behind the	M
being on ponies	M
and another cover from my	M
#kuwtk airs guys! it\u2019s sunday	M
amp; article berger ben cover! check for great lori new out thanks the watts	F
#acmawards50 entertainer help of the vote: win year!	F
her loves shane some she uncle	F
insane! rozzi's so	F
#we'reclapping4everything and at because but clapping everyone else game have idea is just keep moment no that when why you're you	F
:) amp; at daddy game hanging river the	F
#gopreds #nashville event! excited first river's sporting so she's	F
all be dj guest i\u2019ll this the week!	F
1st 6:30 :( and be dropped last mine off one picked to the up was	F
freakin good is impressive lord!! my oh that	F
change for far haha! i'm lazy lovely meet that to too won't you	F
always girl!! love seeing you	F
at elizabeth for fairmont fun had in la montreal!! much queen river so thank to the voix with you	F
so	F
totally yeah	F
averted bruised cover crisis holy hand have it's just might mic my not seriously that whew!	F
#fuelisontheway :) coffee he's home husband he just loves me my on picking said the up way	F
back haha plan up	F
#bajiraomastani\u201d an along extra got haha it kill legs!! nail off our rehearsals!!let\u2019s to toe with	F
#bezubaan different emotion...:-) from	F
hahah!we're	F
and admired all always best for have looked to the up very you	F
#thejourneysong always car filming! in our played song that the while	F
bit deserve every it! of proud sooo soo soooo you!!!congratulations!!!you	F
ada biasanya cinta di kakak-adek'an setiap terpendam yang	M
bakal betah buat cozy disini dan gw gue ke lama2 makasih materi nongkrong siapin standup sini tmptnya tmpt tes udh yg	M
abis baru bgt comedy dua gue jam lega mic materinya materi open sampai standup tes ternyata	M
goler2an part	M
adalah di hari minggu makan tepat untuk yang	M
artinya awal bola buat cewek: cepet2 cowok dia itu kamu keburu kalau lebih mau malam mingguan nonton ngajak pulangin supaya	M
awight	M
ada atau di dvdnya dong, gue mau ntar ndak nonton perform	M
bahan besok buat comedy diksi dan edit memilih mic merampingkam ngerapiin open pas set, standup yg	M
abis buku, baru comedy film ini istirahat jg jgn2 koala keluar kumal lg mulai nulis setelah standup taun tahun	M
berbanding bahan di dgn garing jumlah kehabisan kencan karena kemacetan lurus mobil pertama tingkat yg	M
beserta bersiap berusaha doaku dan histeris jomblo2 ke kawinan ketika kalian, mantan menangis sedang tidak untuk wahai yg	M
baru cinta, deh disuruh juga nanti namanya ninggalin temen ya yah	M
abis baca buku dapet dari email koala seseorang yg	M
(buat aku aja bobo duluan kerja kalau mau masih nanti rumah sayang sampe watsapp ya yg	M
baru bibirnya cieeeeee dehidrasi karena nangis pacaran pecah2 sebulan soalnya yg	M
lagi nih nagih pengen un	M
#minuevovicio \n#mynewvice all c\u00f3mo comenz\u00f3 es how is it remembering recordar todo	F
the universe	M
(nota: \u00e9 amando botafogo, demais! eu j\u00e1 nasci ser sem tripudiando) tripudiar vai vasco	M
as com cuidado	M
is it the way	M
and concentrate love:	M
apoio amostra do de livros obrigado pelo	M
choose can't life, our we	M
#fato coelho paulo quem	M
saturday	M
and concentrate love:	M
and books	M
bom de fim semana	M
are who	M
#sonofthecongo 9pm amazing at check documentary et film make on out sure tonight to	M
all act be don't did even had if like my man our team talkin we wouldn't whole year	M
guy is ridiculous sheesh this	M
i'm	M
answering couple feel hit like me questions	M
og ron the with	M
forsure know lol me since that this tell who you	M
guy! help someone! this	M
do don't love parade you	M
#radio blame bring children\u2019s kicks kevin needy on off programming schools turk! what	M
#cartoon03 boing! is oddity! one space	M
dancing liked nyc on of really streets the w\/ x8	M
#cartoon03 ariana an boing! did grande order returns! someone	M
2001 anyone get it if make reference would	M
bunny see that the where's	M
for like many mate now on so waiting	M
#girlsnightin a'partying by chicks! led	M
and city card credit even found greater! guy in it! make my named nyc on returned street tony thanx the this tony! you	M
$$$$$$! and are alone champaign, cup christy custard doug get is il! jarling\u2019s recipe selling! sale! the worth	M
as are found fades, lost the winter	M
#ridemovie! both! going!! hunt helen i'm love made surfing! she	M
cruel it of out takes winter you	M
be last let month of please storm this the	M
area back bay day!!! in over school to the weekend was	M
by deluxe for golden ii line like lotta machine rattletrap shield smith-corona that the types voyager words	M
and all but gift his is long leonard live mr more nimoy prosper spock to than us was	M
someone took tumble! yeow!!	M
and conquering first indian making no now proud! saina spot the us women	M
ad amazing check entries for\u00a0#crashthepepsiipl! have left me more! out some saw this week's wanting you	M
becoming become congratulations for first have indian made no.1! shuttler to the us woman world you	M
#nh10 and away am an blown brilliant by film just love my outstanding performance specially so what watched	M
do live my on obsession pitch the where	M
bit check isn\u2019t i\u2019m it myntra notice on out still tee the wearing wrogn want	M
are all best for give it jai our ready sir thank to we wishes you your	M
and also bless blessings bhai congratulations dhoni for fatherhood god happy lots may news of sakshi to this wonderful you	M
and belt fashionable it's if leave shoes say to unmatched your	M
are birthday born! day football happy legends when	M
and brown black clash fashionable it's if say to	M
and absolute court day forget greatness i'll never on off the	M
and ahead always b'day bhai best great have happy in life legend rahul the wish year you	M
and by enlightening everyone film great loved movie pk saw spiritually team the what work whole with yesterday	M
all for great it million! making new possible quick ride start thank that to the wow was you year	M
all happy new very wish year you	M
christmas everyone merry	M
#sidsessions awesome! christmas ep is it the watch with	M
awesome finals guys! have in job literally! semi spot secures tables turned the	M
colour! ddd green guardians hilarious! is my of soooo the with	F
at best festival! film kom mary stockholm the won yay!!	F
and all best the	F
nargilove's	F
haha!	F
#powernap #tiredselfies both haha it! losing now	F
#bajiraomastani #lawni #rehearsal gaye!!!!! thak	F
along haha it kill legs!! let\u2019s off our rehearsals!!! to with	F
girls have just wanna	F
2003 2000 debut do film hero hilarious india\/miss miss the world! year	F
all ddd for feedback! love loving this! thanks the tell trailer us	F
much so thank	F
love	F
thank	F
and always an amazing bday forever haaaappy queen to woman	F
thank yay	F
bloody clothes emperor's full hell is new of stuff this	M
clothes emperor's new	M
for new podcast	M
fella for if loads of people reiterate slander the what which was	M
fella for if loads of people reiterate slander the what which was	M
fella for if loads of people reiterate slander the what which was	M
everything going i'm long of solve term to this take vision week will yours	M
also bloody	M
am find out role the till what wait you	M
but for is of out places plenty see sold to there's	M
ling long	M
#acmawards50 danandshay for oliviaculpo pumped performance so this with	M
acms	M
and act class hell of	M
at auburn crazy crowd university	M
#ufcnewjersey after at bus boy back cub!!! fight! gig go lets my on tour the watching	M
fight great	M
amazing! for great thanks were you	M
auburn! ready to you	M
#betterthesecondtime again at coachella drake gonna is if madonna make out with wonder	M
for finished just pumped rehearsal so sunday! this the with	M
#dallas be excited giveaway how in my or pic show showing to tag using vid vip win you'd	M
congratulations friends in my night! on opening to	M
fun paris thank that was	M
\"jealous\ france! in me now on perform see to tune vous	M
came everyone for great had live nrj out! performing sessions, such to thanks time who	M
and all be back by bonjour for glad having me of paris! studio, the to thanks	M
#voiceresults 8\/7c \"chains\ at during in live me perform see tonight to the tune	M
#hardfight \n#yagunnersya again did heads in it!!\ud83d\ude4c\ud83d\ude0a i've keep may! my pay respect reading see to today: up! weee wembley, your you	M
#yagunnersya \ud83d\ude0a atmosphere! around be create calling great gooners hope many there to tomorrow will wembley	M
\ud83d\udc4c btw: crew check for guys, hi interview! my nice out please shirt! signed to thanks the win	M
\ud83d\udc4d\ud83d\ude0a	M
#yagunnersya #bfcvafc 8th \ud83d\udc4d \ud83d\ude0e \ud83d\ude0a\u270c and another done! enjoy for gooners! in job row second week win weekend, your	M
\ud83d\ude0a\ud83d\ude0a best happiness is it multiply others share to the way with your	M
#yagunnersya \ud83d\ude0a \ud83d\udcaa and day family!\ud83d\udc4d for great happy! in row! seven so simply the wins whole	M
#yagunnersya \ud83d\udc97	M
#bigmatch #afcvlfc \u26bd\u26bd\u26bd\ud83d\udd25 matchday!!! tomorrow	M
home sweet	M
bro! birthday, happy	M
#nickelodeon \ud83d\udc4c\ud83d\ude03freue award dich deinen dir du es f\u00fcr feiere genie\u00df hast mich sch\u00f6n und verdient!	M
#geoger \u2714\ud83d\udc4d\u26bd\u26bd and deserved exactely points safe! three the we well wanted	M
#training \u270c days georgia germany! have in left match points to two take the three until we	M
#aus 2:2 \u26bd\u26bd against concentrate from fully friendly group in match next now on our opponent to the we've	M
#worldchampion #geraus #asiancupchampion \u270c\u26bd against it's the tomorrow	M
#gunners great it like work	M
#nufcvafc #bpl #yagunnersya 60 \ud83d\udc4d \u2714 and as hope next points possible return soon to team the win!	M
#ucl and after be game hard it's kicked of out result so such to the	M
\u201cschizophrenics amp; amazing, be can friend good has lam mothers my schizophrenia the useful written	M
choy, fat hei kung	M
#qi 19th and americans: at catch do dear enjoy february hello, hope on premiering this thursday week you	M
#qi 19th, american at coming february friends friendly is that this thursday, to warning	M
#mentalhealth \u00a32k ayse for film friend help is it in my make of raising short support will your	M
#followscotland #cwc2015 as cricket cup good in luck new on to take they the world zealand	M
adopted at day for have infinite this the valentine's what word will you	M
against be by beaten br\u00e9on in lifetime of or raped song support stop their violence will women	M
\u201csearch an been for irish idea: incoherent, i\u2019ve impossible just maybe man or reality show unfriendly unenthusiastic, woman\u201d	M
announcement small	M
(thanks are be know my non-nuclear, plums pleased to you\u2019ll	M
and but enjoy family finally it it\u2019s like loud, made mean-spirited, to twitter temperamental welcome well, you	M
#myheartage 61 \u2026 dear fyi is old oh poor	M
#myheartage find heart healthy how is to take test the your	M
don\u2019t finish my not very what wise you	M
#belfast amp; enjoy events fest great hot ideas imagine! new of politics plenty	M
#fuelpoverty 2015 end help in pls support	M
thank you!	M
and being congrats for from great host last lovely night putting show such thank team up you	M
and all dressed for fun fearless inspiration last my nite the#iaaawards up	M
amp;\nd fest future grassroots in little participated stars superstars the who	M
but broken every ever fully fixable is know nothing problems problem the to trick which	M
above be for grudges hate hold it impossible if love nature of or rise to the true understand will you	M
and anything kiss laugh made never quickly, regret slowly,forgive that uncontrollably, you	M
!! baat can't hai kya to wait	M
always as disappoint loved never rocking trailer! the	M
advance adventure! be congrats check great hahaha in it out promises this to	M
,n al around.u change downer.get day fails hv15 hrs.if it logic on started those use up who	M
best effects hard i've in long mr promises pays promos! seen special time these the work	M
dance didi feet gift heart made my on thank warm you your	M
ad an boy ban enhance fluency handicap-a insensitive.want irresponsible intex its of product stutter sumthing using wth	M
are not tourists...we we	M
ahead balance before got in learn speed to you	M
and all at for friends hospitality love my miss thank to we you your	M
bengali didi full inspiring miss much meeting of so was which warmth	M
what	M
besserung freisto\u00df friend!! get gute my soon well	M
liverpool my	M
2008 about anything, argue can't great gaffa lack may of pace quotes run spain the visi\u00f3n win you your	M
be by it idols isn't legend nice of one to visited your	M
am at anfield it's official, playing	M
hero my	M
brent dance david the	M
500 an alle! guten galaxie it isn't morgen	M
ditto gracie! thanks	F
amp; better...she came good get got gma lil lady my please recently send so sick this trying visit vincent	F
awesome austin! from far it you're	F
\ud83d\ude14 appreciate for i'm know, much support so sorry the thank we you	F
\ud83d\ude80 dear! here my thanks	F
:) amanda, me thanks	F
announcement big coming friends my shortly stay tuned	F
it's it just lol not, swear thought was	F
about amp; are cute?! cactus from how like let's listen mom my new splitter talk...&amp; use wait! was	F
:) an adult! being congrats day great had hope happy inken!! love on sending you've	F
amp; bff coming check friend good! has it looks movie new out so,my so the	F
#latergram amp; catch check mo my of one?! out sister slow this themadgrace vid will	F
#honeyimgood \"aw all already baby's baby, dude got is love\ me my nah of so talented wrong	F
guys serious?! thank you	F
for support see thank you! your	F
could everyone lol! respond see though to wish	F
all had hope lovely sunday	F
\u2764\ufe0f mazzaro michele pietrino82	F
#repost repostapp.\u2070\u30fb\u30fb\u30fb\u2070day with	F
love	F
starting teeth whitening!	F
miss	F
\ud83d\udc59 for gr8t my new swim start thank to week! wear!! you	F
\ud83d\udc99\ud83d\ude2a\u2714\ufe0fjust do gain no pain.no	F
another for ready today! workout	F
#smoothie and after between full just keeps me meals out! shakes started working	F
at bless girl lovely me made met selfridges smile today who	F
#workout and day good healthy lunch!!!!!	F
\ud83c\udf1f about great go here hair heard healthier longer things we	F
#rankin by next out rankinphoto shot week wonderful	F
#alaia \ud83d\ude0d bless	F
#zimmericelab \ud83d\udc23freezing chickens! easter! happy into my our spring way	F
#majorsituation from love my trainer waist	F
\ud83d\ude4f best carlo, monte seafood	F
#kuwtk 9\/8c all at don\u2019t forget is new on tonight	F
arrived coachella just khloes party	F
additions brand collection: new our to	F
!!!! ahhh!!!! cover dream is my what	F
already are cocowhiteuk from teeth thanks! whiter	F
all an channel catch coast! change e! five minutes more new now right to the west	F
#kuwtk 20 almost coast east is it\u2019s minutes more time! until	F
#kuwtk brand don't forget is new	F
collection exclusively festival here! is now our shop season	F
30 almost brand coast! minutes more new our turn until west	F
#kuwtk are coast! east ready starts you	F
#kuwtk all an don\u2019t miss new	F
but created easter god happy in i'm me this the way world	F
amp; another blue could covered eyes have hair in pink wish world yes,	F
amp; black for got head just lol light lights media neon on photographer social so to those time the used	F
at collection festival new our shop season!	F
besties dropped fuck her itunes it's music my on of one video with woohoo!! you	F
brand catch coast! e! five into minutes more new now right to tune west	F
coast! east hour it\u2019s left time until	F
#club! #paraguay, #jockey 25 el estan en listos nos proximo sabado vemos	M
#guatemala #iloveyouguys #liveshow #ontheroad #touring #sexandlovetour	M
#crazy #fans are best! egyptian fans guys meet my of some these the	M
long this time was	M
#nopants #thehangover #alangarner #mvie are know who you	M
d\u00edas en nos paraguay! vemos	M
#freakoutdiaries	M
#bailando #spanish #youtube 10 all cracked did guys it! most of on top time the videos viewed we	M
#freakoutdiaries	M
#m\u00e9xico\u2026 \u00a1boletos agotando! est\u00e1n lo no se te vip	M
#jack, #superstar #dogs #soccer #mycrazydog #chesapeakebayretriever #mansbestfriend #dog player! the	M
harder is it this than	M
#mexico #latinamerica #enriquepitbulltour! amp; came everyone for i'll of out round see that thx to the you	M
#la! #staplescenter #soundcheck at in	M
#guatemala #helicopters #happyeaster #flying for great lessons last show thanks	M
#guatemala #city #volcano #agua hope in landing one's this	M
#sneakpeek hotel inside my	M
and bars for it keepin key my manly off our pipes practicin slightly the warmin	M
#furious7 $1billion 17 crosses days history it's in made mark official: record time the we	M
actually fact gratitude is isn't moment on of shit share this that to the w\/ wanted y'all	M
be can't only surely the	M
(just 12 \"funny\ awesome an personal remember seconds smelled shake the that tip weight was your	M
#tbt \"taualuga\ as culture called dance honor in men samoan special there's the very we, where	M
man totally thx	M
and always balls buddy, but it, it's moan rub say so smile true with when wink you your	M
and hard keep laughs remember to the	M
fun good in i'm my on resuscitation specialize thing to watch	M
#becautious #silverbackontheleftisdangerous #approachhimwithpheromonesandtequila amazing dna	M
and biz development forgot film forget great good my not of remember to tv thing week	M
backstage chick cool fun lil w\/	M
ha left	M
#sanandreas and epic, hold may on spectacular terrifying	M
and birthday fun great have honey!! happy looks on pink	M
crying do don't friend just my start using	M
#sanandreas and brace hold massive on relentless, ride's thrilling this yourself	M
did indeed personally send that to	M
and beauty cool finally genuine her lilly matches meet pleasure quality real that to very	M
and attack defense dominated game, important our solid strong three the we was	M
ataque dominamos defensa el en fuertes fuimos muy partido, puntos s\u00f3lidos tres todo	M
100 but congratulations everyone for goals left on reaching sour thank taste to the want yesterday	M
100 ayer amargo agradecer con dejar de d\u00eda el fue goles haber llegado los mensajes no por pero quiero sabor tantos un	M
arrived! back-up best derby for has love on ps playing til though then the you,	M
amo cl\u00e1sico con de el full la lleg\u00f3 mientras, mejor ma\u00f1ana! play para refuerzo te	M
are fans my me, with	M
kun versus	M
easter, felices happy para pascuas todos!\/	M
asier! asier!! bienvenido christel!\/ congratulations felicitaciones flamantes los new pap\u00e1s to the welcome,	M
and back between before clubs heading nice our to talk with	M
antes clubes charla con de entre linda nuestros regresar	M
and balance c'mon, days good great positive share these team to tour the up we win wrapped with	M
bueno balance buen cerramos compartir con d\u00edas el estos gira grupo la muy positivo triunfo un vamos	M
cumple de d\u00eda este feliz hinchas independiente los nuestro por saludos todos vamos	M
101- 103 buena de despu\u00e9s final! gracias indiana la lindo por qu\u00e9 washington	M
#nba c'mon, for night pacers rooting wizards with	M
#nba aguante con de el haci\u00e9ndole indiana noche pacers vamos washington wizards	M
aguante arroz cereales comiendo con de el mate tomando	M
\"want class day morning me\ of song to the want with	F
birthday! best fun much so	F
family favorite in love my place the wonderful world,with	F
birthday! dogg day my on of snoop song the	F
be ellen excited next on thank the to week! you	F
13 beauty birthday best from her happy moments posh present: to u!	F
and birthday babies david great having my what with year!	F
!! at everyone good it's luck that to time! vb	F
and earth,wind flour laugh me made	F
excited for show tonight!	F
\ud83d\udc60\u2764\ufe0f\ud83c\udf49 dress in prada!! playing up	F
all beverly customers came hills in ladies my red! thank that to vb yesterday!	F
and all an amazing day for thank to team the vb yesterday!	F
at beckham in last looking night preaw15 stunning vb victoria	F
and at came david dinner everyone last night! thank to vb who with	F
and at christopher david handsome last looking night! vb	F
dinner fun last night! vb	F
bald going is	M
good morning!!	M
but chasing lose lot money never of women, women you	M
\u2764\ufe0f \ud83d\ude02 but for fun! it little rusty thanks tampa was	M
be crazy gonna is tampa	M
fun shoot today	M
8.3	M
do day figure here in la my of out rest sitting trynna to the what with	M
follow me on	M
#thispicwasntposediswear #whatisaclookingat \ud83c\udf0a miami skyline	M
everything going ride try to	M
did it\ud83d\ude01...snapchat: ok	M
coming on out tampa!!! who's	M
31 dies haha have lucky my only phone quick too	M
angeles los whaddup	M
:) birthday good have happy	M
come! here la	M
#bestie biz did gals of start to the want your	F
#nationalsiblingsday happy	F
#themindyproject #minimindycollection bid coats for finale on watch	F
#gimmefive amp; chk easy eat fruits is it more peeps! sharing to veggies ways	F
ask for fashion, fitness me more on questions using workouts your	F
beauty in latest my post: pre-workout routine steal	F
#honestbabycarrier -available cute how new our	F
#entrepreneurlife conference executive gr8 had my story sharing time women's	F
#brothers amp; body film forget!! final hugs last love many my never of soul shot that the will	M
debut dear friend give his has him khan made my on sajid twitter,please warm welcome	M
#terimerikahaani,without :) all amazing been couldnt for have it love lady possible thank this ur	M
all ever! fields feeling golden happy lush of punjab...best running through the very wishing you	M
:) at from for fab goodies my super thank these to team you	M
and at blessings day for gurudwara it's in now of patiala, started time the waheguru's with	M
#terimerikahaani 1st called from here's like romantic song track the	M
again back does friend he is khan my out sajid sajid-style this truly week what with	M
#indiasgottalent at brave don't dancing dares in man please supporting try this underwater who young	M
#scionofikshvaku,a book cover indian lord launched make of relevant ram will which youth.lookin	M
0902-966-9999 amp; are call edition fav grabs hybrid headphone limited my on speakers to twist up	M
1st 24\/7 2day :)time at buy best celebrity channel deal! homeshopping has india's launched quality	M
article check fiction friend his is khan my out stranger sajid than truth writes	M
#gabbartrailer and all been for, here\u2019s have know let look me the what waiting you	M
#gabbartrailer after excited for here's if know me more of poster seeing this the u'll	M
#gabbarisback! brand don't forget here's new of poster to the watch	M
apni agar bimaari! chhod corruption do hai jaan ki pyaari,	M
corruption doge gabbar ka ki laat! padegi saath, toh	M
7th and bowl congrats catch consecutive india into match! on semi-finals! their team the what way win!	M
girlies	F
2015 class of	F
air channel! it's magazine my new show sa that will	F
#fwordoutloud airing be channel for look my on of regional soon! taping today's the will which	F
#fwordoutloud airing be for look my on of regional taping today's will which	F
anyone best does have hahahaha! laugh of photo seller swimsuit this trip	F
#fwordoutloud \u2764\ufe0f about beautiful back for got history in learn of this to time the went	F
huh this what's	F
naks!	F
and ang cartwheel forward gusto gymnastics! hay! instagram ko kamusta magaral naman ng pursue roll still sa should talaga that	F
#fwordoutloud \ud83d\udc8b \n\ntrivia: around between dream ever for first in my on playing set takes when	F
it's in udine	F
#mogwaicurtissmith #catlove client for first getting his raymond ready shoot santiago's today	F
#mogwaicurtissmith client for first getting his ready shoot today	F
#thegifted again come!!!! eat excited for film! festival far film here italy leave this to thanks we watching	F
at credits did everyone end gifted! of thank that think twist to the what watched you yey!!!	F
be back barcelona for happy in to the	M
barcelona contento de disputar el para volver	M
con libro mucha mi nuevo su suerte toni t\u00edo	M
29\/04 algunos con de el este en ganas jugar\u00e9 la los pista particip\u00e9is quiz que tenis veros	M
and amazing company carlo debut great in monte my preparing views with	M
buena compa\u00f1\u00eda carlo con debut el en incre\u00edbles monte muy preparando vistas	M
amiguetes!\nin car coche con dos el en little my two the with	M
#montecarlo beautiful incredible most of one places tournament the view	M
#montecarlo bonitos de del el incre\u00edble los m\u00e1s sitios torneo todo uno vista	M
all amp; congrats for kim the wish wedding you your	M
boda enhorabuena kim muy por que se\u00e1is su	M
:)\nalready carlo en in monte ya	M
\u00daltimo antes before casa de en entrenamiento for hacia leaving monte-carlo!\nlast practice session salir	M
:)\ngreat agradable environment entrenar! entorno muy practice! para to	M
clay de la preparando preparing temporada the tierra!	M
de d\u00eda day entreno en in miami!\ntraining	M
#rafanadaltour all best competing everyone how happy is in progressing starts see stage that to the tomorrow	M
#rafanadaltour \u00a1\u00c1nimo avanzando barcelona! contento como de en empieza etapa la los ma\u00f1ana particip\u00e1is que sigue ver	M
#historiastattooadas \u00faltimo barcelona, bon buen con disco dia! de d\u00eda el en empezando rollo ya	M
#laureusawards #cantona	M
#laureusawards #shangh\u00e1i con de del en inicial laureus ni\u00f1os partido shangh\u00e1i saque	M
algunos con de del el en f\u00fatbol grandes laureus los partido preparando shangh\u00e1i	M
batido con d\u00eda da energ\u00e9tico el entrenar empezando fuerza feliz me para que s\u00e1bado un	M
\u00daltimo con d\u00eda en lanka sri tormenta	M
#udawalawenationalpark,disfrutando de en esta incre\u00edble naturaleza	M
#holidays #platja #beach #relax #paseo	M
#love #paraiso #holidays #piscina #pareja de d\u00edas en pareja vacaciones	M
barcelona, bye see you	M
\ud83d\udcaa abrazo mucha suerte!!!!	M
ets el equip felicitats gran millor!!! seguir visca	M
eres flexible, mantendr\u00e1s si te	M
aquesta ens merda molta nit veiem	M
de d\u00eda del en emotivo la lo libro muy miki os presentaci\u00f3n recomiendo roqu\u00e9 un	M
#fifa contento de del fifa f\u00fatbol grandes la momentos muy recordar sede visita	M
jo llibre no quin res tinc	M
for ready	M
great what	M
londres	M
all dificult for good in match support thank win you your	M
afectados al ayuda colabora con en env\u00eda guerra irak la los ni\u00f1os por siria sms	M
congrats well	M
alps amics als de els fam\u00edlies l'accident les meus not\u00edcia pensaments totes una v\u00edctimes van	M
alpes accidente amigos de del en familias los las mis noticia pensamientos todas una van v\u00edctimas	M
and alps all airplane crash devastating families friends go my over of out to today's the thoughts victims	M
\u00a1apoya contra con gana holanda infantil la lucha obesidad un viaje	M
el veranito ya	M
cup! selfie the with	M
fun friend good my mario on set with	M
#puma be commentator right really should	M
\n#headtohead beat do think what you	M
#teamspirit game, night, win!!!! what	M
of proud the team!	M
#evopower ever got i\u2019ve more power than	M
\ud83d\ude09\u26bd\ufe0f\ud83c\udfc3 con marta silva	M
\nkiss and and\/or make mila tom	M
\nwon't about i'm join to watch you	M
i'm impressed well,	M
changed the	M
best last my night's show,	M
\"redeployment.\ award book collection for his national of short stories, tonight: the won	M
best last my night's show,	M
and can charity don't desk for it, it if i'm like my off re-gift raffling shaped win you	M
artist hip hop platinum-selling tonight:	M
best last my night's show,	M
as cologne fact: fun same the uses	M
\"the from interview.\ movie, new tonight: the	M
and at desk empty fireplace great in i'm look my off raffling studio tv they'll your	M
chance desk! enter for full-scale in it'll look my perfect raffle this to win your	M
best last my night's show,	M
$10 could desk donation home image in looking my or remodel to win your you	M
an arrow black from guest had intimidating interviewed luckily leftover richard smaug that time was	M
count don't ever is if last my next show thursday tonight you	M
about ask guest hobbit! him i'll is let me my of questions star some tonight the	M
#hotpursuit \ud83d\udc83\ud83d\udc83\ud83d\udc83\ud83d\udc83\ud83d\udc83dallas first go!! here press tour!! we	F
beso don francisco le los mando no s\u00e1bados ser\u00e1n un ya	F
burn cake last learning night to the with	F
18th \"happy birthday birthday\"?\u201dhappy can it's me my today, wish you	F
flawless is	F
go here	F
acms at excited for her hot pursuit!! song so the vote wrote	F
!!!! #majorleague and cerrano guest is pedro playing special the	F
bob gusta hasta le	F
am best ever!! giant now rose!! set viva	F
1176 at bethesda, go md!! new out piece rocking sofia team	F
bed on of up woke	F
almost home new our	F
by joejonas	M
by headbang joejonas	M
\ud83c\udfca\ud83c\udffd\ud83c\udfca\ud83c\udffd\ud83c\udfca\ud83c\udffd\ud83c\udfca\ud83c\udffd\ud83c\udfca\ud83c\udffd\ud83c\udfca\ud83c\udffd by joejonas	M
by dance joejonas morning swan	M
do let's this	M
by dj joejonas snake	M
now| |live	M
backstage by chillin joejonas with	M
gonna haters	M
feelin	M
let's	M
happy to	M
birthday! happy	M
at alesso be coachella! cool perform see so stoked this to watching who will with	M
#sleightofmouth 12:30am! airs at buddy comedy\/magic my on special tonight tune	M
have peaceful	M
fella good work	M
derek: special the	M
#derekspecial comments for heartwarming love much on so thanks the wonderful your	M
abusers absolutely animal amp; been by condemnation faith humanity hunters i've in of overwhelmed poachers, restored trophy unanimous your	M
anti-gun anti control homophobe i'm not pro-gun pro-abortion pro-choice simply trophy	M
army are get if not protecting shot they're they the veterans wildlife	M
about amp; can did donate even help here just learn stop scum that them the you	M
agradeciendo amor cierra chespirito cuenta, como el estos esta infinitamente le lo pidi\u00f3, que regalaron seguidores: sus se todo	M
amado amo: amor, como de el florinda fue gracias gomez gran hombre los meza mi por que roberto recordar tanto	M
cada ciudad canc\u00fan como con de demasiado disfrut\u00f3, el en es espacio, grande las m\u00e9xico mas mi mueble para tal una vez	M
a\u00f1os como compartimos casas decidido doloroso de este en felicidad, hacen he llevadero las me mas momento que tal tantos vender	M
amor dieron de este espacio feliz gracias hermosas los le llenando mi navidad por palabras que rober siguen tanto tanto, todos	M
12, azteca amor de despedirlo el en esperamos estadio familia, gracias la los las ma\u00f1ana nombre para por partir tanto	M
amor, mi para todo	M
abrazo, aqu\u00ed amigo: cari\u00f1o con de estoy tu un	M
\"los diez del en felicidades, fin licensing\ libro mandamientos mi maca por publicado	M
\u00a1muchas abrazo, amigo: gracias marco! ti, tu un	M
amigo: gracias grande, mas melany mi son tu tesoro ustedes	M
amigo: fifaluis felicidades, muchas tu	M
amo yo,	M
#finalelcolordelapasion \u00a1mucha corrijo,	M
\na alegr\u00eda at dar fans! forward giving joy looking match nuestra our stadium! to tomorrow, una yankee	M
at bell by have happy nyse opening ringing represented to the wall	M
al abriendo bolsa de el en feliz mercado representar wall	M
day game in	M
16,000th 16.000 abono el entregar give it of placer pleasure season the ticket was	M
training!!!	M
al be back buenas de equipo!!! feliz good!!! group!!!feeling happy muy to the very volver with	M
beautiful empire state	M
behind classes english hard here is i'm my on story the working	M
and all be can\u2019t come disappointed from fans help i\u2019ll our play supporting stands tonight team the with	M
al ayudar apoyando con desde esta equipo estar\u00e9 fans grada jugar la no nuestros noche puedo	M
again at fans forward feeling looking on of our support stadium saturday to the yankee	M
9:10pm ad at featuring my new on scary tonight	M
#spierathlon 13 de grootste het juni je ouder-kind organiseert schrijf sportevenement!	M
and again able be back fit forward group great happy looking my next play session training to the today was with	M
dinner darts great good league legends luck premier tomo the with your	M
#nedspa against boys! during every good in luck match memorable spain this tonight the wc way was	M
20.45 against big good game holland local side turkey tonight time very vs	M
come	M
#mufc #legendsareback and among between bayern hear is in june\u2019s legends match nice to the	M
couple en going in is lads of practice well weeks with	M
amazing gift get game got of play prepared send this to	M
94 and at grandfather game last looking me my oranje supporting still with wim year	M
good luck	M
dina gold gymnastics girl medailles my of proud so she today! with won	M
and green healthy my quick salad veg	M
2day and by book.guess book celebrated day favorite hat inspired kids made my school that their which world	M
chinese check for happy more my new on out profile sina weibo year!!	M
and all at best darren fletcher great professional top the wba	M
:) bt check did for guest out persie sport! shaqueel star: special this van video	M
42nd at backpack black cab email find it, in if left me my nyc's near seriously, street you	M
42nd and at bag city dropped in left my new off street the york	M
all day night	M
#dearjohn bowen check from friend good his have is it lot movie marty memories my newest now out on of working with	M
and came find first get home in little monkey mmxxl my t-shirt!! their to wifey	M
#magicmikexxl, approve bearing came cool fans gifts helped mike make not only these they think us would	M
and almost an finding hopeless is of out productivity separates situation talk those what who	M
\n#nevergiveup and always best do give loyal! never stay up, your	M
and after beer coffee days for few germany here is it in london now strong time unpredictable we wonderful	M
all around always another day effort for great is it or opportunity takes us, usually will wait you	M
#raw! arena and be find hosts in out see should think to tonight the tune very vocal why	M
and always alive, because comes down damn find good it, it in life, pretty try to the that's when you're	M
clean check for free filed, month new of subscribers, taxes underwear,	M
always are count it in make matter no place to there's the where world, you	M
#wweglasgow an amazing at crowd event friends how is in long my off start to that today's trip! undeniably	M
and between, everything from fabulous guy in johnny roll thank to up wacky	M
#fastfamily #1 congrats, from in movie not now on such surprising support see to the world	M
#raw after as airs be first his i'll is live network on oh podcast there tonight the yeah,	M
#nevergiveup achieve excellence focused keep motivated opportunity pushing seize	M
and burden biggest can is lift many of peacefully recharged stress times the weight wonderfully you	M
anything, as but can can't do days day everything, feel is long lost never some	M
and but better downs freezes feeling have heart is no relationships races there than time ups when your	M
another but before couple can first finally her is months on of over take the wait	M
250 certainly doesn't get he if out rohit will	M
and batted class everyone,sheer for in rohit.thats rohit talent.enjoy the very well witness	M
and abhishek energy game him.i have has.was he is just knowledge much no1 nice outstanding,so our really say to the with	M
and as after back chennai came didn't defeat disappoint fans game.team house played strong the us,full very well	M
be chennaiyin chennai fc.finally front fans.vanga game home in of second there to vandhu watch will	M
after bed.early day,time equaliser.saw football game hit in last long,fantastic manutd matches min one play saw start three to the	M
also,hope clue crackers good.happy had it's make no	M
all atleast be diwali.feels dog good house home.my happy is like not other over running shivering she to the very wish you	M
as balwant but chance consider good missed start that the to will	M
2morrow's and abhishek being dani for his has practice penalty pick report there to thks team the up vita with	M
1st balwant becoming congrats for in indian score singh to the	M
1st 22 and basically can elano ever football for get have himself jersey keep means myself,my my no so that to the will	M
but by certainly cards few gift have he lost may opponents,fantastic play pace pires quite robert some to will yellow	M
both far.no from game isl of played players so side well	M
big don't day have leave missing match on of put risk so this to the want	M
almost for is me,thanks my norton ready to this	M
another from pic	M
(including 80s \"first and best day everyone in myself) nice of outfit their the today wearing weather\ was	F
and btw, carter's enjoy for just kids love myself.\ud83d\ude0d my more on shopping spree that than went	F
and at are cause can't kids miss nanas sleeping sleep them	F
are but even for going here i\u2019m my not on ok politics, running start so to thoughts with	F
believe didn't from for here's like me magic! my trainer those waist who worked	F
10 \u2764\ufe0f going heels in i'm like minutes regret ready stripper these to wedding	F
\ud83d\ude0d\ud83d\ude0d fan had letter share this to touching with you	F
be day episode for heroes life my of one to want	F
jam out pre work yassss	F
built baby be cluttered house living our room swore that this toys we wouldn't when with	F
#mybiggirl are chair! daughters for high joovy loving my nook!!! the thank we you	F
gets it's she when	F
\ud83d\ude01 about blend came excited from good heard in many my slender so things	F
awesome are dreams heroes insanely my no re-watching series the wonder	F
#naturallyshow \u2764\ufe0f amp; new show with	F
7th and all be celebration, follower going is in keeps love merch! million me my some support sending signed what will your	M
another do have i'll one then to	M
girllll preetttyyyy	M
\ud83d\ude02 laugh me made soooo this	M
smile!	M
from got home just kiss love!!!!!!! lovely much so sharon! studio to the	M
and family love, my of sending thinking you your	M
good morning!	M
easter happy	M
\ud83d\ude0a is listening me making smile! this to	M
girrrrrl hey	M
recording	M
ahh!!	M
\u00f1 as coisas desando eu falar interessam que sim, vezes	M
\u00e9 \u00d1 ambiente cena do esse faust\u00e3o no pra personagem quadro rabo sempre stand-up tomar vai	M
10 \u00e9 cena cara do durante entra ele faust\u00e3o imposs\u00edvel ir legal minutos maaanoo personagem tem uma zoa	M
\u00e9 com\u00e9dia com faust\u00e3o humor no	M
apagada\u00e7o atropelando clevelanda celtics com lebron um	M
eu	M
na porra! passa que sky s\u00f3	M
boa!	M
boa	M
ae aproveita gravar pra que sp ta vc vindo vamos	M
\u00e9 \u00fanico crime com dele empresa ele governo h\u00e1 ind\u00edcio n\u00e3o nisso pro presta que servi\u00e7o	M
\u00e9 condenar cara h\u00e1 ideol\u00f3gico ind\u00edcio muito nenhum n\u00e3o precipitado posicionamento por pelo receber	M
#nba #ufc assisto assistir assistindo b\u00f4as de eu fam\u00edlia gravo mais mma madruga na pra qdo sempre tarde	M
dallas foda rockets	M
\u00e9 agora boa! mesma vc	M
18 ani amp; benggala bersama di harimau ii ibu koleksi mencapai putih seekor sby tsi	M
2014 anak baru bulan betina diberi di gajah ii, lahir memberikan nama november pada sempat sby tsi tsb utk yg	M
(18\/4) (tsi) amp; berakhir di indonesia ii, jawa ke keluarga pekan prigen, sby safari sabtu sore, taman	M
18 2005, asia april afrika bandung di gedung konferensi merdeka, meninjau presiden persiapan selaku sby	M
akademik asean amp; beri civitas di ekonomi hadapi hadapan indonesia ilmiah jg kesiapan masy orasi perguruan peran sby ttg tinggi,	M
(beragama) aktif atas amp; bangsa dianugerahi guru gelar moestopo majukan oleh peran sby universitas	M
2015 anak-anakku amp; dgn dimudahkan hasil junjung kejujuran, lulus menempuh nasional semoga sma\/smk siswi selamat siswa terbaik ujian	M
amp; asia agar antar damai, ekonominya kerjasama kesejahteraan kawasan negara perlunya pasifik rakyat stabil sby tekankan tumbuh	M
akademis amp; beri di dr dihadiri ekonomi, forum ini, keynote pagi politik, seluruh singapore sby speech tokoh yg	M
2015 ani amp; bertemu dg diselenggarakan international ibu juga oissa panitia symposium sempat singapore sby yg	M
asean amp; berharap dpt iseas jelang kearifan kemajuan kesejahteraan kawasan memberi pengalaman perdamaian, pandangan, sby utk	M
(institutes asia asian bermarkas di iseas kajian lembaga merupakan of pusat studies) southeast terbaik tenggara yang	M
(10\/4) bambang dikukuhkan di dr distinguished fellows honorary iseas jumat oleh prof susilo sbg yudhoyono	M
bunga di gugur indonesia mengenal pusara para prajurit saat seroja, sby tmp tsb tabur timor timur tugas yg	M
(9\/4), 10 amp; cruz, dili, hari ini ke leste lalu makam pahlawan santa sby seroja taman th timor yg ziarah	M
744 di dili, danyon foto infanteri keluarga ketika mjd sby timur, tahun timor	M
di ini istimewa ke krn kunj leste, militer mengemban pernah presiden pertama sebelumnya selama sby sana selain sbg th tugas timor	M
alkatiri, amp; disambut gusmao, horta hangat itu jose kala kedatangan leste menlu marie presiden pm ramos sby timor xanana	M
(8\/4), 10 bilateral bahas hr hubungan ini kedua kunjungan ke kenegaraan leste lalu negara sby th timor utk yg	M
apa amp; ada akal disamping dg harus jg kalah kepatutan, kepentingan keadilan mencerdaskan politik sehat	M
27 always age am be damn favourite gotta it i'm my make now number to the this will wanted	F
bath, bad cry, call eat forever feeling film have love like love, lasts may no someone something watch walk	F
and at buckle been come for has on seatbelt sunbathing sly!!! stare to tries the when you	F
are if love not of they the unhappy your you	F
already can have i! neither packed	F
not never or	F
always maybe one	F
can't infuckstry legal reasons this	F
be change do don't deserve fear have live let make out realise to the what win you	F
and it's it it, my of one right re should use write	F
and about are consequence, do happiness happy is it in if life not something the whatever with you your	F
advice admit are be can everything if know learn, never not or to take team win wrong will willing you	F
but have no they	F
know think they	F
and duvet friends film good miss my	F
food indulge in junk need some to	F
always on	F
and as crazy change everything films get how it's in older priorities that watch you your	F
#onofest, 6! arena cincinnati!! door! doors fifth i'm left me meet on some tics third there! tonight we	M
1st back come fire! hampshire in keene luv must new state! soon! time tonight the we was	M
don't give	M
asked her how he prom! to that's	M
\"i dark ft for favorite jheneaiko know\ my on of one paradise sky songs tonight thanks	M
remember	M
in of return studio the	M
come dates live!!! more on see us	M
give her that	M
album listening this to	M
love	M
4eva dogs! me my yeah,	M
(on aunties, atl! came dad's grandma in me my realist! side) see to they the uncle,	M
#uncf \"one behalf bout can change for foundation my man on of perform rip to the world\	M
\ud83d\udd25 case in missed this you	M
canada! day for g's! incredible in last show shows tonight! thanks the	M
