lauramarano	F
katyperry	F
taylorswift13	F
ladygaga	F
rihanna	F
britneyspears	F
JLo	F
KimKardashian	F
shakira	F
selenagomez	F
Oprah	F
aliciakeys	F
MileyCyrus	F
NICKIMINAJ	F
AvrilLavigne	F
EmWatson	F
MariahCarey	F
xtina	F
kourtneykardash	F
Beyonce	F
khloekardashian	F
ashleytisdale	F
tyrabanks	F
ClaudiaLeitte	F
carlyraejepsen	F
kelly_clarkson	F
deepikapadukone	F
paurubio	F
priyankachopra	F
VictoriaJustice	F
lindsaylohan	F
KylieJenner	F
victoriabeckham	F
jessicaalba	F
annecurtissmith	F
SofiaVergara	F
snooki	F
JessieJ	F
KELLYROWLAND	F
ciara	F
sonamakapoor	F
SarahKSilverman	F
jennettemccurdy	F
shireensungkar	F
Fearnecotton	F
bellathorne	F
143redangel	F
elissakh	F
DulceMaria	F
realpreityzinta	F
KeshaRose	F
gulbenergen	F
juliaperrez	F
bipsluvurself	F
shreyaghoshal	F
Adela_Micha	F
officialtulisa	F
AshBenzo	F
EleanorJCalder	F
belindapop	F
LAURAGII	F
DollyParton	F
MadhuriDixit	F
Fergie	F
PrincesSyahrini	F
dilmabr	F
GiulianaRancic	F
NellyFurtado	F
HillaryClinton	F
TherealTaraji	F
ana_maria_braga	F
pattiemallette	F
jessicacediel	F
nikkigil	F
aristeguicnn	F
GemmaAnneStyles	F
SaraBareilles	F
PaulaFernandes7	F
RobertsEmma	F
maddow	F
DaniellePeazer	F
danawhite	F
damnitstrue	F
JanetJackson	F
AndreaSernaRCN	F
RealTracyMorgan	F
MarthaStewart	F
LaurenConrad	F
HaifaWehbe	F
michkeegan	F
heidiklum	F
DaRealAmberRose	F
geneliad	F
Su_Gimenez	F
ashleesimpson	F
Alyssa_Milano	F
ashleeadams	F
KateEllisMP	F
jaamiecurry	F
LiamMcEwan	F
jk_rowling	F
sachin_rt	M
justinbieber	M
BarackObama	M
jtimberlake	M
Cristiano	M
Harry_Styles	M
jimmyfallon	M
KAKA	M
Drake	M
BillGates	M
BrunoMars	M
KingJames	M
pitbull	M
Eminem	M
Louis_Tomlinson	M
KevinHart4real	M
davidguetta	M
aplusk	M
danieltosh	M
ConanOBrien	M
ActuallyNPH	M
SrBachchan	M
JimCarrey	M
chrisbrown	M
RyanSeacrest	M
edsheeran	M
ParisHilton	M
iamwill	M
LeoDiCaprio	M
iamsrk	M
aamir_khan	M
SnoopDogg	M
kanyewest	M
SimonCowell	M
narendramodi	M
BeingSalmanKhan	M
WayneRooney	M
DalaiLama	M
ZacEfron	M
KendallJenner	M
paulocoelho	M
KDTrey5	M
tomhanks	M
imVkohli	M
rustyrockets	M
nickjonas	M
stephenfry	M
iHrithik	M
TheRock	M
AustinMahone	M
akshaykumar	M
StephenAtHome	M
JohnCena	M
msdhoni	M
CherLloyd	M
BigSean	M
JColeNC	M
carmeloanthony	M
ImRaina	M
kobebryant	M
Pharrell	M
juniorbachchan	M
rioferdy5	M
karanjohar	M
PerezHilton	M
DwightHoward	M
SteveMartinToGo	M
andersoncooper	M
shahidkapoor	M
iansomerhalder	M
paulwesley	M
SeanKingston	M
TheShilpaShetty	M
alexoficial	M
ChrisMoyles	M
FinallyMario	M
BillSimmons	M
JakeTAustin	M
JoshDevineDrums	M
samuelmilby	M
neiltyson	M
finkd	M
Angelluisr	M
JoelOsteen	M
JoyceMeyer	M
jackwhitehall	M
questlove	M
BradPaisley	M
billclinton	M
Schwarzenegger	M
chrisrock	M
DrakeBell	M
JamesFrancoTV	M
1LoganHenderson	M
dylanobrien	M
themichaelowen	M
jamesmaslow	M
DaneCook	M
DavidHenrie	M